á|always, ever, forever
á-belgan|cause to swell in anger, incense, anger
á-beodan|announce, offer
á-bidan|await, (abide)
á-brecan|break into, break
á-bredwian|kill
á-bregdan|move rapidly (trans.)
á-bréotan|destroy, cut down, kill
á-búgan|bend away, turn away, deviate, start
ac|but
á-cennan|beget, bear, produce
á-cígan|call forth, summon
á-cwellan|kill, (quell)
á-cweðan|say, utter, ("aqueath")
ád|funeral pile/fire/pyre
ád-faru|path (to) funeral pyre
ádl|sickness, disease, infirmity
á-dréogan|endure, suffer, ("adree")
á-fédan|bring up, raise
á-fyllan|fill (instr., with)
á-galan|sing, chant
ágan|possess, have
á-gangan|come to pass, occur, befall
ágen|own
agend|owner
á-gifan|give (in return)
ág-laéca|demon, fiend, monster
ág-laéc-wíf|female fiend/monster/demon
á-gyldan|pay, permit, make possible, requite, ("a-yield")
áh, áhte|see ágan.
an-hár|singularly hoarry, very grey
á-hebban|raise, lift, draw, (heave up)
áh-laéca|see ág-laéca.
á-hléapan|leap up
á-hli(e)hhan|laugh
áhsian|ask, seek for
ge-áhsian|learn by inquiry/asking, hear
áht|anything
á-hyrdan|harden
á-laétan|leave, give up
aldor(-)|see ealdor(-).
á-lecgan|lay, lay down
á-léh|see á-léogan.
á-léogan|belie, fail to perform, leave unfulfilled (a promise)
Alf-walda|ruler of elves (epithet for Beowulf ?)
á-licgan|fall, fail, cease
á-limpan|befall, come (to pass)
al-walda|omnipotent (one), god
á-lýfan|allow, grant, entrust
á-lýsan|loosen, take off
an|see on.
an-|see on-.
an|see unnan.
án|one
ancor|anchor
ancor-bend|anchor-rope
and-, ond-|stressed prefix, usually indicating opposition, negation
anda|anger, indignation
and-git|understanding, discernment
and-léan, ond-léan|reward, requital
and-long|extending away in the opposition direction
an-drysno|propriety, courtesy, etiquette, respect, reverence
and-saca|enemy, adversary
and-swarian|answer
and-swaru|answer
and-weard|opposite, standing over against
and-wlita|face
án-feald|simple, plain, unmixed, modest, (one-fold)
ánga|sole, only
an-gaet|see on-gitan.
án-genga|solitary one, one who goes alone
an-gyldan|pay (a penalty) for
án-haga|solitary one, recluse
an-hár|very hoary
an-hýdig|resolute, strong-minded, stubborn, constant, ('single-minded')
á-nyman|take away
án-pæð|narrow path, one-by-one path, lonely way
an-raéd|resolute, perservering, constant
an-sund|sound, uninjured
an-sýn|appearance, form, sight
án-tíd|fixed/appropriate time, time when something is due
ánunga|entirely, by all means, certainly
an-walda|ruler, sovereign, god
ár|messenger, herald
ár|honour, worth
á-raéran|raise up, (rear up), establish, exalt
ár-fæst|honourable, virtuous
árian|show mercy, spare
á-rísan|rise, arise (lit. & fig.)
Ár-Scyldingas|see Scyldingas.
ár-stafas|support, assistance, kindness, grace, favour
á-secgan|tell, declare, speak out
á-settan|set, place, appoint, establish
á-singan|sing (to an end)
á-standan|stand up, get up
á-stígan|ascend, arise (lit. & fig.)
á-swebban|(put to sleep [lit.]), kill
atelíc|horrible, dreadful
á-téon|draw
áter-tán|('poison twig' [lit.]), poison stripe
atol|horrid, dire, terrible
attor|(animal) poison, venom
attor-sceaða|poisonous enemy/criminal
áð|oath
á-ðencan|think, intend
áð-sweorð|sworn oath, solemn oath
áþum-swéoras|son-in-law and father-in-law
áwa|always
á-wrecan|recite, tell, declare, speak out
á-wyrdan|injure, destroy
aéd(e)r|(vein), stream, (artery)
aédre|speedily, early, forthwith, directly, instantly, fully
aéfen|evening
aéfen-grom|angry/hostile/fierce/(grim) in the 'evening'
aéfen-léoht|evening-light
aéfen-ræst|evening-rest
aéfen-spraéc|evening-speech
aéfnan|perform, do
ge-æfnan|carry out
aéfre|ever, at any time (in any case)
æfter|after
æf-þunca|vexation, displeasure, chagrin
aég-hwá|every one, everything
aég-hwaér|everywhere, always
aég-hwæðer|each (of two)
aég-hwylc|each (one), every (one)
aég-laéca|see ág-laéca.
aég-weard|watch by the sea/shore
aéht|property, goods, wealth
aéht|pursuit, chase
æhtian|see eahtian.
ge-æhtle|consideration, esteem
aéled|fire
aéled-léoma|gleam of fire, torch
Ælf-here|kinsman of Wígláf
æl-mihtig|almighty (god)
æl-with|alien being, strange creature
aéne|once
aénig|any
aén-lic|only, unique, peerless, excellent, glorious, beautiful
aénne|see án.
æppel-fealu|bay, (apple-fallow)
aér|before
aér-dæg|early day, day-break
aérende|errand, message
aérest|see aér.
aér-fæder|old father, forefather
aér-gestréon|ancient treasure/wealth ("i-streon")
aér-geweorc|work of olden times, ancient work
aér-gód|good from ancient times, old and good
ærn|house, dwelling, building
aéror|see aér.
aérra|former, earlier
aér-wela|ancient wealth/treasure
aés|food, meat, carrion, carcass
æsc|(ashen) spear
Æsc-here|a counselor and warrior of the Danes, close companion of Hróðgár
æsc-holt|(ash wood, i.e.) spear
æsc-wiga|(spear) warrior
æt|at, near, in (place, circumstance, time)
aét|meal
æt-bearn|bear (to), carry (to), bear away
æt-féolan|stick to, hold firmly
æt-ferian|carry away
æt-gædere|together
æt-gifan|give
æt-graépe|grasping at, aggressive
æt-hrínan|touch
æt-hweorfan|turn, go
æt-rihte|immediately, (right away)
æt-somne|together
æt-springan|spring forth, flow out
æt-standan|stand fixed, stop
æt-steppan|step forth
ættren|poisonous, venomous
æt-wegan|carry, carry away
æt-windan|flee away, escape
æt-wítan|reproach, charge, blame [somebody] for something, censure
æþele|noble, excellent, glorious, splendid, valuable
æþeling|noble, prince, man of royal blood, chief
æþelu|not found
æðm|breath, breathing
bá|see bégen.
baldor|see bealdor.
balu|see bealu.
bám|see bégen.
bán|bone
bana|(bane), slayer, killer, murderer
bán-cofa|body, (bone-chamber)
bán-fág|adorned with bone (antlers?)
bán-fæt|body, (bone-vat)
bán-helm|bone-helmet (or -protection), i.e. shield(?)
bán-hring|vertebra, (bone ring)
bán-hús|body, (bone-house)
bán-loca|muscle, flesh
ge-bannan|bid, order
ge-barn|see ge-byrnan.
bát|boat, ship
bát-weard|boat-guard, boat-keeper
baédan|compel, urge on
baél|fire, flame
baél-fýr|funeral fire
baél-stede|place of the pyre
baél-wudu|wood for the funeral pyre
baér|bier
(ge-)baétan|bridle, bit, (saddle?)
bæð|bath
(ge-)béacnian|point out, shew
beado|war, battle, fighting, strife
beado-gríma|war-mask, war-helmet
beado-hrægl|war-garment, coat of mail(?)
beado-léoma|battle-light, i.e. (flashing) sword
beado-méce|war-sword, battle-sword
beado-rinc|warrior, battle-man
beadu-folm|battle-hand
beadu-lác|war-sport, battle-play
beadu-róf|bold in battle
beadu-rún|battle-rune
beadu-scearp|battle-sharp
beadu-scrúd|(battle-shroud), war-garment
beadu-serce|(battle-sark), coat of mail
béag|(precious) ring, circlet
béag-gyfa|ring-giver
béag-hroden|ring-adorned
béah|see béag, búgan.
béah-hord|ring-hoard, treasure
béah-sele|ring-hall, hall (in which rings are given)
béah-ðegu|receiving of a ring
béah-wriða|ring-band, ring, circlet
bealdian|show oneself brave/bold, bear oneself's bravely
bealdor|prince, lord
bealo, bealu|baleful, evil, pernicious
bealo-cwealm|baleful death
bealo-hycgende|intending evil, hostile
bealo-hýdig|intending evil, hostile
bealo-níð|baleful enmity, wickedness
Béan-stán|father of Breca
bearhtm|brightness
bearm|bosom, lap
be-arn|see be-irnan.
bearn|child, son
bearn-gebyrdo|child-bearing
bearu|grove, wood
béatan|beat, strike, pound
be-béodan|command, order, bid
be-beorgan||protect/guard oneself
be-búgan|encompass, surround
be-bycgan|sell
be-ceorfan|cut off (deprive by cutting)
bécn|see béacen.
be-cuman|come
bed(d)|bed
ge-bedda|bed-fellow
be-daélan|deprive
be-fæstan|entrust, commit, give over
be-feallan|fall
be-fléon|flee from, escape
be-fón|seize, encompass, encircle, envelop
be-foran|before
bég|see béag.
be-gang|see be-gong.
bégen|both
be-géotan|pour over, anoint, infuse, flood (with), sprinkle
be-gitan|get, obtain
be-gnornian|lament, bemoan, mourn for
be-gong|circuit, compass, expanse, region
be-gylpan|boast, exult
be-healdan|guard, hold, occupy
be-helan|hide
be-hófian|have need of, require
be-hón|hang (round/about with)
be-hréosan|fall
be-irnan|run (into)
bél|see baél. be-léan|(blame)
be-léosan|lose
(ge-)belgan|enrage
be-limpan|happen, befall
be-lúcan|lock up, close
be-murnan|mourn over, bewail, deplore
ben|wound
bén|petition, request
béna|petitioner, petitioning
benc|bench
benc-swég|bench-noise, convivial noise, sound of rejoicing (in the hall)
benc-þel|bench-plank
bend|bond, fetter
be-nemnan|declare, stipulate
be-néotan|deprive of
ben-geat|wound-opening, (wound-gate), gash
be-niman|rob, deprive of
béodan|offer, tender, give
ge-béodan|offer, show
béod-genéat|table-companion
béon, béo(ð)|see eom.
beor|beer, strong drink
beorg, beorh|hill, cliff, elevated shore
beorgan|preserve, save, protect
ge-beorgan|protect
beorh|see beorg.
beorht|bright, shining
Beorht-Dene|see Dene.
beorhte|brightly
beorhtian|sound clearly/loudly
beorn|see byrnan.
beorn|man, hero, warrior
beorn-cyning|hero-king
béor-scealc|beer-drinker, feaster
béor-sele|beer-hall, banquet/feast-hall
béor-þegu|(beer-taking), beer-drinking
béot|boast, promise
ge-béotian|boast, vow
béot-word|vow, boast, word of boasting
Béow(ulf)|Danish king, son of Scyld
Béowulf|the hero of the poem: Geatish warrior (and later king), son of Ecgþéow & kinsman of Hygelác
beran|bear, carry, wear, bring
ge-beran|bear (child)
be-réafian|bereave, despoil, deprive
be-réofan|deprive
berian|bare, clear, clear away
berstan|break, burst(intr.)
be-scúfan|shove, thrust
be-settan|set about, adorn
be-sittan|besiege
be-smiþian|fasten
be-snyððan|desprive
be-stýman|wet
be-swaélen|scorch, burn
be-syrwan|ensnare, entrap, trick
ge-bétan|improve, remedy, cure, amend, repair, compensate, atone
be-timbran|build, construct
bet-líc|excellent, splendid
be-wægnan|offer
be-wennan|attend to, entertain
be-weotian|see be-witian.
be-werian|protect, defend against
be-windan|wind about, grasp, bind, enclose, encircle, mingle
be-witian|watch, observe, attend to, watch over
be-wyrcan|build around, surround
bí|see be.
bicgan|see bycgan.
bid|abiding, halt
bídan|bide, wait, stay, remain, dwell
ge-bídan|await
biddan|ask, request, entreat, bid
bi-fón|see be-fón.
big|see be.
bi-gong|see be-gong.
bil(l)|sword
bindan|bind, join
ge-bindan|bind
bi-néotan|see be-néotan.
bío(ð)|see béon.
bíodan|see béodan.
bíor-|see béor-.
biorh|see beorg.
biorn(-)|see beorn(-).
bis(i)gu|see bysigu.
bítan|cut, bite
bite,|bite, cut
biter|sharp
bitre|bitterly, sorely
bið|see eom.
bi-wennan|see be-wennan.
blác|shining, brilliant
blanca|horse
blæc|black, dark
blaéd|power, vigour of life
blaéd-ágande|prosperous, glorious
blaéd-fæst|glorious
bléate|wretchedly, pitiably
blícan|shine, gleam
blíðe|joyful, blithe
blíð-heort|blithe of heart, cheerful
blód|blood
blód(e)gian|make bloody
blód-fág|blood-stained
blódig|bloody, blood-covered
blódig-tóð|with bloody (tooth) teeth
blód-réow|blood-thirsty
blonden-feax|(having mixed hair, i.e.) grey-haired
bodian|announce
bolca|gangway of a ship
bold|building, house, hall
bold-ágend(e)|house-owner, house-owning
bolgen-mód|enraged
bolster|bolster, cushion, pillow
bona|see bana.
bon-gár|deadly spear
bord|board, shield
bord-hæbbend(e)|(board-having), shield-bearer
bord-hréoða|shield-covering, shield
bord-rand|shield
bord-weal(l)|'shield-wall', (protective) shield
bord-wudu|shield
born|see byrnan.
bót|relief, remedy
botm|bottom
brád|broad, wide, spacious
ge-bræc|crashing
Breca|chief of the Brondingas
brecan|break
ge-brecan|break, crush, destroy
brecð|breaking, grief
bregdan|move quickly (trans.), draw, swing, fling
ge-bregdan|draw (sword)
brego|chief, lord
brego-róf|very valiant, famous
bredo-stól|princely seat, throne, principality
bréme|famous, renowned
brenting|ship
bréost|breast
bréost-gehygd|thought of the heart
bréost-gewaéde|breast-garment, coat of mail
bréost-hord|(breast-hoard), breast|heart
bréost-net(t)|breast-net, mail-coat
bréost-weorðung|breast-ornament
bréost-wylm|(breast-welling), emotion
bréotan|(break), cut down, kill
brim|sea, water (of sea, lake)
brim-clif|sea-cliff
brim-léad|sea-passage, voyage
brim-líðend(e)|seafarer
brim-stréam|sea-stream, ocean-current, sea
brim-wísa|sea-leader, sea-king
brim-wylf|she-wolf of the sea/lake (i.e., Grendel's Mother)
brim-wylm|surge (wealling) of the sea/lake
bringan|bring
ge-bringan|bring
bróden|see bregdan.
bróden-maél|see brogden-maél.
bróga|terror, horror
brogden-maél|(ornamented with a wavy pattern, i.e.) damascened/pattern-welded sword
brond|burning, fire, (brand)
Brondingas|Scandinavian tribal name (unidentified)
bront|steep, high
brosnian|decay, corrupt, rot, fall to pieces
bróðor|brother
ge-bróðor|brothers
brúcan|make use of, enjoy
brún|bright
brún-ecg|with a bright (burnished
brún-fág|of a brown colour, shining
brýd|bride
brýd-búr|woman's apartment(/bower)
bryne-léoma|gleam of fire
bryne-wylm|surge/wealling of fire
brytnian|deal out, dispense, distribute
brytta|distributor, dispenser
bryttian|distribute, dispense
búan|dwell
ge-búan|(ingressive) take possession of, settle in
bufolc|neighbouring people
búgan|bow (intr.)
ge-búgan|bow (intr.)
bunden-heord|with hair bound up or, possibly, cruelly bound (bunden-heard)
bunden-stefna|ship with bound prow
bune|cup, drinking vessel
búr|chamber, apartment, dwelling
burh|fortified place, castle, palace, stronghold
burh-loca|walled town
burh-stede|castle court, courtyard
burh-wela|wealth of a castle/town
buruh-ðelu|castle-floor
burne|stream
búton|but
bycgan|buy, pay for
ge-bycgan|buy, pay for, obtain
byldan|encourage, cheer
býme|trumpet
ge-byrd|fate
byrdu-scrúd|'birth-garment (shroud)'
byre|son
byrele|cupbearer
byreð|see beran.
byrgan|taste, eat
byrht|see beorht.
byrig|see burh.
byrnan|burn
ge-byrnan|burn (intr.), be consumed
byrne|mail-coat, ring-mail/chain-mail armour, byrnie
byrn-wiga|mailed warrior
bysigu|affliction, distress, trouble, care
byð|see eom.
býwan|polish, adorn, prepare
Cáin|biblical person: first son of Adam & Eve, brother (and slayer) of Ábel
camp|battle, fight, strife, contention
can|see cunnan.
candel|candle, light
caru|see cearu.
ceald|cold
céap|purchase, bargain
(ge-)céapian|trade, purchase
cearian|care, be anxious
cearig|full of care, grieving, sorrowful
cear-sið|expedition that brings sorrow (care)
cearu|care, sorrow, grief
cear-wælm, -wylm, |(care-welling), seething of sorrow
ceaster-búend|town-dweller, castle-dweller
cempa|champion, warrior
céne|bold, brave, (keen)
cennan|declare, show
cennan|bring forth, bear (child)
cénðu|boldness
céol|ship
ceorl|man, fellow, bloke, chap (originally, freeman)
céosan, cíosan|choose, taste, try
ge-céosan|choose, obtain
clam(m), clom(m)|clasp, grip, grasp
clif|cliff
ge-cnáwan|recognise
cniht-wesende|being a boy
cnyht|boy
cnyssan|dash against, strike, smite, crash (together)
cól|cool
collen-ferhð|bold of spirit, excited
con, const|see cunnan.
corðer|troop, band, host
costian|try, make trial of
ge-cranc|see ge-cringan.
cræft|strength, power
cræftig|strong, powerful
cringan|fall (in battle), die
ge-cringan|fall (in battle), die
cuma|comer, visitor
cuman|come
cumbol|banner, standard
cunnan|know
cunnian|try, make trial of, tempt, explore
cure|see céosan.
cúð|known, well-known
cúð-líce|openly, familiarly
cwealm|death, killing
cwealm-bealu|death-evil (-bale), death
cwealm-cuma|murderous visitor
cweccan|shake, brandish
cwellan|kill
cwén|wife (of a king)
cwén-líc|queenly
cweðan|speak, say, quoth
ge-cweðan|say
cwic(o)|living alive
cwíðan|bewail, lament, mourn for
cyme,|comimg
cymen|see cuman.
cým-líce|beautifully, splendidly, nobly
cyn(n)|race, people, family
cyn(n)|proper proceeding, etiquette, courtesy, custom
ge-cynde|innate, natural, inherited
cyne-dóm|royal power
cyning|king
cyning-bald|'royally brave', very brave, kingly bold
kyning-wuldor|the glory of kings
ge-cýpan|buy
ge-cyssan|kiss
cyst|choice
cýðan|make known, show
ge-cýðan|make known, announce
dagian|dawn
ge-dál|separation, parting
daroð|javelin
daéd|deed, action, doing
daéd-céne|daring (keen) in deeds
daéd-fruma|doer of deeds
daéd-hata|one who shows his hatred by deeds, persecutor, ravager
dæg|day
Dæg-hrefn|a warrior of the Húgas (Frisians), possibly the slayer of Hygelác
dæg-hwíl|day-while
dæg-rím|number of days
daél,|part, portion, share, measure, a (great) deal
daélan|deal (out), distribute, dispense
ge-daélan|distribute
déad|dead
ge-déaf|see ge-dúfan.
déagan|conceal (be concealed?)
déah|see dugan.
deal(l)|proud, famous
dear, dearst|see durran.
déað|death
déað-bed(d)|death-bed
déað-cwalu|death by violence, death-throe
déað-cwealm|death-slaughter
déað-dæg|death-day
déað-faége|doomed to death, dead
déað-scua|death-shadow
déað-wérig|(weary to death)
déað-wíc|death-place
ge-défe|fitting, seemly
déman|judge
démend|judge
den|den, lair
Dene|Danes (national and geographical designation)
déofol|devil, demon
déog|see déagan.
déogol|secret, hidden, mysterious
déop|deep
déop|deep
déope|deeply, solemnly
déor|brave, bold, fierce
deorc|dark
déore|dear, precious, excellent, beloved
déor-líc|bold
déor-mód|bold, brave
déoð|see déað.
déð|see dón.
ge-dígan|pass through safely, survive, endure
díope|see déope.
díor|see déor.
díore|see déore.
disc|dish, plate
dógor|day
dógor-gerím|number of days
dohte(st)|see dugan.
dohtor|daughter
dol-gilp|foolish/audacious boasting, foolhardiness
dol-líc|foolhardy, audacious, daring
dol-sceaða|mad ravager, desperate foe
dóm|(doom), judgment, decree, authority
dóm-léas|inglorious, honourless
dón|do, act
ge-dón|make, render
dorste|see durran.
draca|dragon
ge-dræg|bearing, concourse, (noisy) company
dréam|joy, bliss, rejoicing, mirth
dréam-healdende|joyful, blessed
dréam-léas|joyless
dréfan|stir up, excite, make turbid
dréogan|act, bear oneself
dréoh-fáh|stained with gore/blood
dréorig|bloody, gory
ge-dréosan|fall, decline
drepan|(IV), strike, hit
drepe|blow, stroke
drífan|drive
driht-|see dryht-.
drihten|see dryhten.
driht-gesíð|retainer, comrade
drincan|drink
drinc-fæt|see drync-fæt.
dríorig|see dréorig.
drohtoð|way of life, course
dropen|see drepan.
drúsian|grow still
ge-dryht, -driht,|troop, army
dryht-bearn|noble child
dryhten|lord (retainers' chief), prince
dryht-guma|retainer, warrior, man
dryht-líc|noble, lordly, splendid
dryht-máðum|noble treasure, splendid jewel
dryht-scype|valour, bravery
dryht-sele|princely hall (originally, retainers' hall)
dryht-sib(b)|peace, alliance
drync-fæt|drinking-vessel, cup
drysmian|become gloomy, become obscure
ge-dúfan|plunge in, sink in, dive [fr. deriv. dýfan] (in)
dugan|avail, be good, be strong, be capable of
duguð|body of (noble/tried) retainers, host
durran|dare
duru|door
dwellan|mislead, hinder, stand in one's way
dyde, dydon|see dón.
ge-dýgan|see ge-dígan.
dýgel|see déogol.
dyhtig|strong, good
dynnan|resound
dýre|see déore.
dyrne|secret, hidden
dyrre|see durran.
dyrstig|daring, bold
éac|also, moreover
éacen|large, mighty
éacen-cræftig|exceedingly powerful, huge
Éad-gils|Swedish prince, son of Óhthere
éadig|prosperous, happy, blessed
éadig-líce|happily
eafor|see eofor.
Eafor|see Eofor.
eafora, eafera, |offspring, son, posterity, child, successor
eafoð|strength, might, power
éage|eye
éagor-stréam|sea-stream, sea
Éaha|a (Half-)Danish warrior
eahta|eight
eahtian|consider, deliberate (about something)
eal(l)|& subst., all
eald|old
ealder-|see ealdor-dagas.
eald-fæder|father, ancestor
eald-gesegen|old tradition (saga)
eald-gesíð|old comrade/retainer
eald-gestréon|ancient treasure
eald-gewinna|old adversary ('hostis antiquus')
eald-gewyrht|result of former deeds
eald-hláford|old(perhaps 'dear' or 'rightful') lord
eald-metod|god of old
ealdor, aldor|chief, lord, prince, (elder)
ealdor, aldor|life
(e)aldor-bealu|injury to life, death
(e)aldor-cearu|life-care, great sorrow
(e)aldor-dagas|days of life
(e)aldor-gedál|separation from life, death
ealdor-gewinna|life-enemy, deadly enemy
(e)aldor-léas|lord-less, lacking a king
ealdor-léas|lifeless, dead
(e)aldor-þegn|chief thane
eald-sweord|ancient/old sword
eal-fela|very much, a great many
eal(l)-gearo|quite ready
ealgian|protect, defend
eal(l)-gylden|all-golden
eall-íren|all of iron
ealo-, ealu-benc, |ale-bench
ealo-drincend(e)|ale-drinker
éa-lond|water-land, sea-board
ealo-, ealu-waége|ale-cup/flagon
ealu-scerwen|(dispensing of ale i.e.) bitter anguish/distress/terror
éam|(maternal) uncle
Éan-mund|Swedish prince, son of Óhthere
eard|land, estate, region, dwelling, home
eardian|dwell, remain
eard-lufu|(home-love), dear home
earfoþe|hardship, hard struggle
earfoð-líce|with difficulty, painfully, sorrowfully
earfoð-þrág|(time of tribulation), distress
earg|cowardly, spiritless, craven
earm|arm
earm|wretched, distressed, forlorn, pitiful, poor
earme|wretchedly
earm-béag|arm-ring, bracelet
earm-[h]réad|arm-ornament
earm-líc|miserable, pitiable, wretched
earm-sceapen|wretched, miserable
earn|eagle
Earna-næs|a promontory in the land of the Geats, near the scene of the dragon fight
eart|see eom.
éastan|from the east
Éast-Dene|see Dene.
eatol|see atol.
éaðe|easy, pleasant
éaðe|easily
éað-fynde|easy to find
(ge-)éawan|see (ge-)ýwan.
eaxl|shoulder
eaxl-gestealla|shoulder-companion, comrade
éc|see éac.
éce|perpetual, eternal, everlasting
ecg|edge, sword
ecg-bana|slayer with the sword
ecg-clif|sea-cliff (=ég-clif), or cliff with an edge or brink, steep cliff
ecg-hete|sword-hate, hostility, war
Ecg-láf|a Dane, father of Unferð
Ecg-þéow|father of Béowulf
ecg-þracu|sword-storm
Ecg-wela|(unknown) Danish king
éd(e)r|see aéd(e)r.
ed-hwyrft,|return, change, reverse
ed-wenden|turning back, reversal, change
ed-wít-líf|life of dishonour/disgrace
efn|in on
efnan|see æfnan.
efne|even, just
eftstan|hasten (intr.)
eft|afterwards, back, again
eft-cyme|return
eft-síð|journey back, return
egesa|terror, fear, horror
eges-full|terrible
eges-líc|terrible
egl|spike, talon
egsian|terrify
ég-stréam|water-stream, pl. sea
éhtan|pursue, persecute
ehti(g)an|see eahtian.
elde, eldo|see ylde, yldo.
el-land|foreign country
ellen|courage, valour, strength, zeal
ellen-daéd|deed of valour
ellen-gaést|powerful or bold spirit/demon
ellen-líce|valiantly, boldly
ellen-maérþu|fame for courage
ellen-róf|famed for courage/valour, brave, strong
ellen-síoc|(strength-sick), deprived of strength, mortally wounded
ellen-weorc|work of valour, courageous deed
elles|else, otherwise
ellor|elsewhere, death
ellor-gást|alien spirit
ellor-síð|journey elsewhere, death
elne(s)|see ellen.
elra|another
el-þéodig|foreign, strange
ende|end
ende-dæg|last day, death
ende-dógor|last day, death
ende-láf|last remnant
ende-léan|final reward or retribution
ende-saéta|one stationed at the (end) extremity of a territory (i.e. coast-guard)
ende-stæf|end, conclusion
(ge-)endian|end
enge|narrow, close, constrained
ent,|giant
entisc|made by giants
(ge)-éode|see (ge-)gán. [Go. iddja]
eodor|enclosure, precinct
eofer, eofor|boar
Eofor|a Geat, son of Wonréd, brother of Wulf, slayer of Ongenþéow
eofer-spréot|boar-spear
eofor-líc|boarlike (thing)
eofoð|see eafoð.
eolet|sea? voyage?
eom|am, is, are
eorclan-stán|precious stone, jewel, gem
éored-geatwe|warlike equipments
eorl|nobleman, (earl)
eorl-gestréon|(noblemen's) treasure, riches
eorl-gewaéde|dress of a warrior, armour
eorlíc|manly, heroic, noble
eorl-scipe|nobility, rank
eorl-weorod|band of warriors
eormen-cyn(n)|mankind
eormen-grund|spacious (ground) earth
eormen-láf|immense legacy
Eormen-ríc|king of the East Goths
eorre|see yrre.
eorð-búend(e)|(earth-dweller), man, native
eorð-cyning|king of the land
eorð-draca|earth-dragon
eorðe|earth i.e., both ground and the world we live in
eorð-reced|earth-house
eorð-scræf|earth-cavern, cave
eorð-sele|earth-hall
eorð-weal(l) |earth-wall, mound
Éotan|'Jutes'
eoten|giant, ettin/eten
eotenisc|made by giants, giantish
eoton-weard|watch against giants
éow|see þú.
éowan|see ýwan.
éower|your
éower|see þú.
ést|favour, good will, boon
éste|kind, gracious
etan|eat
etonisc|see eotenisc.
éð-begéte|easy to obtain (get)
éðe|see éaðe.
éþel|native land, home
éðel-riht|ancestral right, priviliges belonding to a hereditary estate, ancestral domain
éþel-stól|native seat, ancestral throne
éþel-weard|guardian of the native land, king
éðel-wyn(n)|enjoyment of hereditary estate, delight of/for home
éþ-gesýne|easily visible (with the connotation of 'in abundance')
fácen|deceit, malice, crime
fácen-stafas|(baleful runes), treachery letters(?), treachery
fág, fáh|patterned, coloured
fáh, fág|hostile, (foe)
fámig-heals|foamy-necked
(ge-)fandian|search out, test, tamper with
fáne, fára|see fáh.
faran|go, proceed, fare
ge-faran|proceed, act
faroð|current, sea
fæc|space of time
fæder|father
fæder-æþelu|paternal rank/excellence
fæderen-maég|paternal relative, kinsman on the father's side
ge-fæg|satisfactory, pleasing, dear
faége|doomed to die, fated, near death
fægen|glad, rejoicing
fæger, faéger|fair, beautiful
fæg(e)re, faég(e)re|fairly, pleasantly, fittingly, courteously
ge-faégon|see ge-féon.
fægrian|become fair, make beautiful
faéhð(o)|feud, enmity, hostile act, battle
faélsian|cleanse, purge
faémne|maiden, woman
fær|vessel, ship
faér|sudden attack, danger, disaster
faér-gripe|sudden grip or attack
faér-gryre|(terror caused by) sudden attack, awful horror
faéringa|suddenly
faér-níð|hostile attack, sudden affliction
fæst|fast, firm, fixed
fæste|fast, firmly
fæsten|fastness, stronghold
fæst-raéd|firmly resolved
fæt|vessel, cup
faét|(gold) plate
faéted|ornamented, (gold-)plated
faéted-hléor|with ornamented cheeks, i.e., with gold-plated headgear (or bridle)
faét-gold|plated gold
faéttan, faétte|see faéted.
faéttum|see faét.
fæðer-gearwe|feather-gear
fæþm|(outstretched) arms
fæðmian|embrace, enfold
féa|few, a few
féa|see feoh.
ge-féa|joy
ge-feah|see ge-féon.
fealh, ge-fealg|see (ge-)féolan.
feallan|fall
ge-feallan|fall
fealo|see fela.
fealu|fallow
féa-sceaft|destitute, poor, wretched
feax|hair of the head (collect.)
ge-fégon|see ge-féon.
féhð|see fón.
fél|file
fela|nearly always
fela-fricgende|well-informed, wise
fela-geómor|very sad, solemn
fela-hrór|very vigorous, strong
fela-módig|very brave
fela-sinnig|very sinful, very guilty
fel(l)|skin, fell
fen(n)|fen, marshy region
fen-freoðo|fen-refuge
feng,|grasp, grip
(ge-)féng|see (ge-)fón.
fengel|prince, king
fen-gelád|difficult passage/path across water liable to be rendered impassable by flooding in a fen
fen-hlið|?-fen-slope, marshy tract
fen-hop|remote or secret place/enclosure in a fen
féo|see feoh.
feoh|property, money, riches
feoh-gift|dispensing of treasure
feoh-léas|(money-less i.e.) not to be atoned for with money, inexpiable
ge-feoht|fight
feohtan|fight
ge-feohtan|fight
feohte|fight
féolan|penetrate, reach
ge-féon|rejoice
féond|enemy, fiend, foe
féond-gráp|enemy's grip or clutch
féond-scaða|enemy, hostile criminal
féond-scipe,|enmity, hostility
feor(r)|far
feor-búend|far dweller
feor-cýþð(u)|far country
feorh|life
feorh-bealu|(life-bale), deadly evil
feorh-ben(n)|life-wound, mortal wound
feorh-bona|(life-)slayer
feorh-cyn(n)|(life-race), race of men
feorh-geníðla|life-enemy, deadly foe
feorh-lást|(life-track, i.e.) track of vanishing life, bloody trail
feorh-legu|(allotted) life
feorh-séoc|(life-sick), mortally wounded
feorh-sweng|life-blow, deadly swing
feorh-wund|life-wound, mortal wound
feorm|feeding, sustenance, entertaining, taking care of
feormend-léas|without a burnisher/cleanser/polisher
(ge-)feormian|consume, eat up
feormynd|cleanser, polisher, burnisher
feorran|remove
feorran|from afar
feorran-cund|of a far country
feor-weg|far way, (pl.:) distant parts
féower|four
féower-týne|fourteen
féran|(go to), reach, attain, bring about, (fare)
fére|able to go, fit (for military service)
fergend|leader
ferh|see feorh.
ferhð|mind, spirit, heart
ferhð-frec|bold in spirit
ferhð-geníðla|deadly foe
ferh-weard|guard over life
ferian|carry, lead, bring, (ferry)
ge-ferian|carry, (ferry)
fetel-hilt|linked hilt, hilt furnished with a ring of chain
fetian|fetch
féþa|band of foot-soldiers, troop, host, infantry
féþe|going, pace
féþe-cempa|foot-warrior
féðe-gest|foot-guest or -warrior
féþe-lást|walking-track, step
féðe-wíg|fight on foot
fex|see feax.
fíf|five
fífel-cyn(n)|race of monsters, giants, sea-monsters(?)
fíftig|fifty
fíf-týne|fifteen
Fin(n)|king of the East Frisians
findan|find
finger|finger
Finnas|Finns (Lapps)
Finns-buruh|Finn's castle
fíond|see féond.
fíras|men, mankind
firen|see fyren.
firgen-|see fyrgen-.
Fitela|nephew (and son) of Sigemund
flaésc|flesh
flaésc-homa|body
flán|arrow
flán-boga|arrow-bow
fleah|see fléon.
fléam|flight
fléogan|fly
fléon|flee
fléotan|float, swim, sail
flet(t)|floor (of a 'hall')
flet-ræst|(hall-rest), couch in the hall
flet-sittend(e)|sitter in the hall
flet-werod|hall-troop
fliht|flight, flying
ge-flit|contest, rivalry, quarrel, dispute
flód|flood
flód-ýþ|flood-wave, wave of the sea
flór|floor
flota|ship, boat
flot-here|sea-army, naval force
(ge-)flýman|put to flight
folc|folk, people, nation
folc-ágend(e)|leader of a people, chief
folc-cwén|folk-queen
folc-cyning|folk-king
folc-réd|public benefit, what is good for the people
folc-riht|folk-right, legal share of the 'common' estate
folc-scaru|folk-share, public land
folc-stede|folk-stead
folc-toga|folk-leader, chief
Folc-walda|father of the Finn
fold-bold|building
fold-búend(e)|man, earth-dweller, inhabitant of the earth
folde|earth, ground
fold-weg|way, path
folgian|follow, pursue
folm|hand
fón|grasp, grapple, seize
ge-fón|seize, grasp
fondian|see fandian.
for|before, in front of; for, as, in place of
foran|before, in front
for-bærnan|cause to burn, burn up (trans.)
for-beran|forbear, restrain
for-byrnan|burn up (intr.)
ford|ford, water-way (sea)
fore|therefore, fore it; before
fore-maére|very famous, illustrious
fore-mihtig|very powerful
fore-snotor|very prudent, very clever
fore-þanc|forethought
for-gifan|give, grant
for-grindan|grind to pieces, crush
for-grípan|crush to death
for-gyldan|repay, pay for, requite
for-gýman|neglect, be unmindful of
for-gytan|forget
for-habban|hold oneself back, restrain oneself, forbear
for-healdan|disregard, come short in one's duty towards, rebel against, forsake
for-hicgan|despise, scorn
forht|afraid
for-lácan|mislead, betray
for-laédan|lead to destruction
for-laétan|leave, let (go), relinquish, surrender, abandon
for-léosan|lose, abandon, let go
forma|first
for-niman|take away, carry off
for-scrífan|proscribe, condemn
for-sendan|send away, dispatch, put to death
for-sittan|fail, diminish (intr.)
for-síðian|journey astray (to destruction), perish
forst|frost
for-standan|withstand, hinder, prevent
for-swápan|away/off
for-swelgan|swallow up
for-sw(e)orcan|become dark/dim
for-swerian|render useless by a spell
forð|forth, forward, on(ward), away
for-ðám|therefore
forð-gerímed|counted up, in total, all-told
forð-gesceaft|future state, destiny
forð-gewiten|departed, (gone forth, i.e.), dead
forðleoð|song of departure, death-dirge
for-ðon|see forðám.
for-þringan|rescue, protect
forð-weg|way forth
for-weorpan|throw away
for-wrecan|drive away, banish
for-wrítan|cut through
for-wyrnan|refuse
fót|foot
fót-gemearc|foot-mark, length of a foot
fót-lást|foot-print, track
fracod|bad, useless
fram|from
Francan|Franks
ge-fraége|information through hearsay
(ge-)frægn|see (ge-)frignan.
(ge-)frægnian|make famous, infamous
frætwan|adorn, make beautiful
frætwe|ornaments, trappings, decorated arms/armour, precious things, treasure
fréa|lord, king
fréa-drihten|lord and master
Fréa-waru|daughter of Hróðgár
fréa-wine|(friend and) lord
fréa-wrásn|(lordly, i.e.) splendid chain/band
freca|bold one, warrior
frécne|daring, audacious
frécne|daringly, terribly, severely
fremde|foreign, alien, estranged
freme|vigorous, lusty
fremman|further
ge-fremman|advance
fréo-burh|(free, i.e.) noble town
fréod|friendship
fréo-drihten|noble(/dear) lord
fréogan|love
fréo-líc|noble, excellent
fréond|friend
fréond-lár|friendly counsel (lore)
fréond-laþu|friendship, kindness, invitation
fréond-scipe,|friendship
freoðo|protection, safety, peace
freoðo-burh|town affording protection, stronghold
freoðo-wong|field of refuge, fastness
freoðu-webbe|peace-weaver
fréo-wine|noble(/dear) friend
Frésan, Frýsan|Frisians, West Frisians
Frés-cyning|king of the (West) Frisians
Frés-lond|Friesland, Frisia
Frés-wæl|Frisian battle-field
fretan|eat up, devour, consume
fricgan|ask, question
ge-fricgan|learn (orig., 'by inquiry'), hear of
friclan|desire, ask for
frignan, frínan|ask, inquire
ge-frignan|learn, (orig., 'by inquiry'), hear of
frioðo-waér|compact of peace
friðu-sib(b)|pledge of peace
fród|wise, old ('old and wise')
Fróda|Heaðo-Bard chief, father of Ingeld
frófor|consolation, solace, relief, help
from|see fram.
from|strenuous, bold, brave
fruma|beginning
frum-cyn(n)|lineage, origin
frum-gár|('first-spear', i.e.) chieftain
frum-sceaft|creation, beginning, origin
ge-frúnen, -frúnon, -frungon|see ge-frignan.
Frýsan, Frýs-land|see Frésan, Frés-lond.
fugol|bird
full|full
ful|full, very
ful(l)|(filled) cup, beaker
ful-laéstan|help, support
full-éode|follow, serve, aid
fultum|help, support
fundian|strive, be eager to go
furðum|just (of time), first
furþur|further, furthermore, further on
fús|eager to set out, ready, hastening
fús-líc|ready
fýf-týne|see fíf-týne.
fyl(l),|fall
ge-fyllan|fell, kill
fyllo|fill, plenty, feast
fyl-wérig|killed
fyr|see feor(r).
fýr|fire
fýras|see fíras.
fýr-bend|band forged with fire
fyrd-gestealla|war-comrade
fyrd-hom|war-dress, coat of mail
fyrd-hrægl|war-garment, byrnie
fýr-draca|(fire-drake), -dragon
fyrd-searo|armour
fyrd-wyrðe|distinguished (worthy) in war
fyren, firen, |crime, sin, wicked deed
fyren-daéd|wicked deed, crime
fyren-sceapen|wicked, created in sin
fyren-ðearf|dire distress
fyrgen-béam|mountain-tree
fyrgen-holt|mountain-wood
fyrgen-stréam|mountain-stream
fýren|fiery, on fire
fýr-heard|hardened by fire
fyrian|see ferian.
fýr-léoht|fire-light
fyrmest|see forma.
fyrn-dagas|days of old
fyrn-geweorc|ancient work
fyrn-gewin(n)|ancient strife
fyrn-man(n)|man of old
fyrn-wita|old counselor
fyrst,|space of time, time (granted for doing something)
(ge-)fyrðran|further, advance, impel, incite
fyr-wet(t), -wyt(t) [wit(t)]|curiosity
fýr-wylm|surge of fire
(ge-)fýsan|make ready, impel, incite
gád|lack, want
galan|sing, chant
galdor|see gealdor.
galga|gallows
galg-mód|sad in mind, gloomy
galg-tréow|gallows-tree
gamen|see gomen.
gamol|old, aged, ancient
gamol-feax|grey-haired
gán|go
ge-gán|go
gang|going
gangan|go
ganot|gannet, sea-bird
gár|spear
gár-céné|(spear-bold), brave
gár-cwealm|death by the spear
Gár-Dene|see Dene.
gár-holt|spear-shaft, i.e. spear
Gár-mund|father of the Angle king Offa
Gár-ulf|a Frisian warrior
gár-wiga|spear-fight, warrior
gár-wígend|spear-fighter, warrior
gást, gaést, m. -a.,|ghost, spirit, demon
gást-bona|soul-slayer, demon, devil (the name of a particular being?)
gædeling|kinsman, companion
gæst|see gist.
gaést|see gást.
gé,|and
gé,|see þú.
geador|together
geald|see gyldan.
gealdor|song, sound
gealp|see gilpan.
gean|against, towards
géap|curved, vaulted, spacious
géar|year
geára|gp. of géar, long since, (of yore)
geara|see gearo.
geard|(enclosure, hence) dwelling
géar-dagas|days of yore
geare|see gear(w)e.
gearo|ready, prepared, alert
gearo|see gear(w)e.
gearo-folm|with ready hand
gear(w)e|(readily), entirely, well, surely
Géatas|Scandinavian tribe
Geatisc|Geatish
Géat-mæcgas|men of the Geats
geato-líc|equipped, adorned, splendid, stately
geatwa|equipment, precious objects
gegn-cwide|answer
gegnum|forwards, straight, directly
gehðo|see giohðo.
gén|still, yet, further
géna|still, further
gende|see gengan.
gengan|go, ride
génunga|straightaway, directly, completely
géo|formerly, of old
géoc|help
géocor|grievous, sad
geofon|sea, ocean
geofum, -ena|see gifu.
geogoð|youth
geogoð-feorh|(period of) youth
geolo|yellow
geolo-rand|yellow shield
geó-méowle|see ió-.
geómor|sad, mournful
geómore|sadly
geómor-gyd(d)|mournful song
geómor-líc|sad
geómor-mód|sad of mind
geómrian|mourn, lament
geómuru|see geómor.
geond|throughout, through, along, over
geond-braédan|over-spread
geond-hweofan|pass through, go about
geond-séon|look over
geond-wlítan|look over
geong|young
georn|desirous, eager
georne|eagerly, willingly, earnestly
geó-sceaft|that which has been determined of old, fate
geó-sceaft-gást|demon sent by fate, fated spirit
géotan|pour, flow, rush
Géotena|see Géatas.
gest-sele|guest-hall, (royal) hall for retainers
gétan|destory, kill
gid(d)|song, tale, (formal) speech
gifan|give
gifeðe|given, granted (by fate)
gifeðe|fate
gif-heal(l)|gift-hall
gífre|greedy, ravenous
gif-sceat(t)|gift
gif-stól|gift-seat, throne
Gifðas|East Germanic tribe
gifu|gift
gígant|giant
gilp|boast, boasting
gilpan, gylpan|boast, rejoice
gilp-cwide|boasting speech
gilp-hlæden|(vaunt-laden), covered with glory, proud
gim(m)|gem, jewel
gimme-rice|(jewel-kingdom), precious realm
gin(n)|wide, spacious
gin-fæst, gimfæst, |ample, liberal
gingæst|see geong.
gió|see geó.
giofan|see gifan.
giogoð|see geogoð.
giohðo|sorrow, care
giómor(-)|see geómor(-).
giond-|see geond-.
giong|see geong.
gíong, pret.|see gangan.
ge-giredan|see ge-gyrwan.
gist,|stranger, visitor, guest
git|see þú.
gít|see gýt.
gladian|shine
glæd|kind, gracious
glæd-man|kind, gracious
glæd-mód|glad at heart
gléd|fire, flame
gléd-egesa|fire-terror, terrible fire
gléo|glee, mirth, entertainment
gléo-béam|glee-wood, harp, lyre
gléo-dréam|mirth
gléo-man(n)|gleeman, singer, bard
glídan|glide
glitinian|glitter, shine
glóf|glove(?), pouch(?)
gnéað|miserly, sparing
gnorn|sorrow, affliction
gnornian|mourn, lament
god|god, God, deity
gód|good (able, efficient, excellent, strong, brave
gód|good, goodness, good action, gifts, liberality
gód-fremmend(e)|one doing good, acting bravely
gold|gold
gold-aéht|possessions in gold, treasures
gold-fág, -fáh, |ornamented with gold
gold-gyfa|gold-giver, lord
gold-hladen|(laden) adorned with gold
gold-hroden|gold-adorned
gold-hwæt|liberal(?) for gold
gold-máðum|gold-treasure
gold-sele|gold-hall
gold-weard|guardian of gold
gold-wine|gold-friend, (generous) prince
gold-wlanc|splendidly adorned with gold
gombe|tribute
gomel, gomol|see gamol.
gomel-wudu|old-wood, ancient/antique harp
gomen|joy, mirth, sport, pastime
gomen-wáþ|joyous journey
gomen-wudu|wood of mirth, harp, lyre
(ge-)gongan|see (ge-)gangan.
gram|wrathful, hostile
gráp|grasp, claw
grápian|(grope), grasp
graédig|greedy, fierce
graég|grey
graég-hama|the grey-coated one, (wolf(?))
graég-maél|silver- or grey-coloured ('-marked')
græs-molde|grass-mould, greensward, grassland
Grendel|monstrous fen-dwelling being slain by Béowulf
gréot|sand, earth
gréotan|weep
grétan|approach, touch, attack
ge-grétan|greet, address
grim(m)|grim, fierce, angry
grím-helm|mask-helmet, (visored) helmet
grim-líc|fierce, terrible
grimme|grimly, terribly
grípan|gripe, grasp, clutch
gripe,|grip, grasp, attack
grom-heort|hostile-hearted
grom-hýdig|angry-minded, hostilely-disposed
grówan|grow
grund|ground
grund-búend|inhabitant of the earth, man
grund-hyrde|guardian of the earth, warden of the deep
grund-sele|underground hall, earth-hall
grund-wong|ground-plain
grund-wyrgen|accursed (female) monster of the deep
gryn(n)|see gyrn.
gryre|terror, horror
gryre-bróga|horror
gryre-fáh|terrible in its colours
gryre-geatwe|terrible armour, warlike equipment
gryre-giest|dreadful stranger
gryre-léoð|terrible song
gryre-líc|terrible, horrible
gryre-síð|dreadful (perilous) expedition
guma|man, (male human)
gum-cyn(n)|mankind, race, men
gum-cyst|manly virtue, munificence
gum-dréam|joys of men
gum-dryhten|lord of men
gum-féþa|band on foot
gum-man(n)|man
gum-stól|throne
gúð|war, battle, fight
gúð-beorn|warrior
gúð-bil(l)|war-sword (bill-sword)
gúð-byrne|war-mail (armour)
gúð-cearu|war-care, grievous strife
gúð-cræft|war-strength
gúð-cyning|war-king
gúð-déad|death in battle
Gúð-ere|a Frisian warrior
gúð-floga|war-flier
gúð-freca|fighter
gúð-fremmend(e)|warrior
Gúð-Géatas|see Géatas.
gúð-helm|war-helmet
gúð-horn|war-horn
gúð-hréð|glory in battle
Gúð-láf|a Danish warrior
gúð-léoð|war-song
gúþ-mód|of martial mind, warlike-spirit
gúð-raés|storm of battle, attack
gúð-réow|fierce in battle
gúð-rinc|warrior
gúð-róf|brave/infamous in battle
gúð-scear|slaughter (shearing) in battle, carnage
gúð-sceaða|enemy, destroyer
Gúð-Scilfingas|see Scylfingas.
gúð-searo|armour
gúð-sele|battle-hall
gúð-sweord|war-sword
gúð-getáwa|war-equipments
gúð-geweorc|martial action, war-deed
gúð-wérig|war-weary, worn out with fighting
gúð-wiga|warrior
gúð-wine|war-friend, warrior, sword
gúð-wudu|battle-wood, spear
gyd(d)|see gid(d).
gyddian|pay, repay
gylden|golden
gyllan|yell, cry out, resound
gylp, gylpan|see gilp, gilpan.
gylp-spraéc|boasting speech
gylp-word,|boasting word
gýman|care, heed, be intent (on)
gyn(n)|see gin(n).
gyrdan|gird, belt
gyrede, gegyred|see gyrwan.
gyrn|grief, affliction
gyrn-wracu|revenge for injury
gyrwan|prepare, make ready, dress, equip, adorn
ge-gyrwan|make ready, equip
gyst|see gist.
gystran|yesterday
gýt, gít|yet, still, hitherto
gýtsian|covet, be avaricious, be envious
habban|have, hold
hád|manner, state, position, form
hádor|bright, clear-voiced
hádor, n.|brightness
hádre|clearly, brightly
hafa|see habban.
hafela|head
hafenian|raise, lift up
hafo, hafu|see habban.
hafoc|hawk
haga|enclosure, entrenchment
hál|whole, hale, sound, unhurt
Hálga|Danish prince, younger brother of Hróðgár
hálig|holy, (orig., 'whole -ness', possibly ref. to 'charisma' [see Russell])
hals|see heals.
hám|home, dwelling, residence
Háma|a person of the Germanic (Gothic) cycle of legends
hamer|hammer
hám-weorðung|ornament of a home
hand, hond|hand
hand-bona|slayer by hand
hand-gestealla|comrade, associate
hand-gewriþen|twisted or woven by hand
hand-gripe|hand-grip
hand-léan, hond-léan, |see and-léan.
hand-scolu, -scalu, |(hand-)troop, companions
hand-sporu|hand-spur, nail, claw
hand-wyrðe|made worthy by hand, hand-crafted
hangian|hang (intr.)
hár|hoary, grey, old
hát|hot
hát|heat
hátan|name, call
ge-hátan|promise, (vow, threaten)
hatian|hate, persecute
hattres|see attor.
hæf|sea
hæfen|see hebban.
hæft|captive
hæft-méce|hilted sword
hæft-nýd|captivity
hæg-steald|young
haél|safety, good luck
hæle, hæleð|hero, warrior, man
haélo|prosperity, luck, hail
Hæreð|father of Hygd
hærg-træf|holy (heathen) temple
haéste|violent
Hæðcyn, -cen|Geatish prince, second son of Hréðel
haéþen|heathen, pagan, gentile, (lit., 'man of the heath' i.e. a pejorative for 'rustic')
haéð-stapa|heath-stalker (stag)
hé, héo, hit|he, she (she), it
héa-burh|(high burgh), great town
heafo, -u|see hæf.
héafod|head
héafod-beorg|head-protection
héafod-maég|(head-, i.e.) near relative
héafod-segn|head-sign, banner
héafod-weard|head-watch, i.e. death-watch, (wake)
heafola|see hafela.
héah|high, lofty, exalted
héahealle|high hall, august building
héah-cyning|great king
héah-gesceap|(high) destiny
héah-gestréon|splendid treasure
héah-lufu (-lufe)|high love
héah-sele|high (great) hall
héah-setl|high seat, throne
héah-stede|lofty place
heal(l)|hall
heal-ærn|hall-building
healdan|hold, keep, guard, occupy, possess, rule
ge-healdan|hold, keep, guard, rule
healf|half
healf|(half), side
Healf-Dene,|king of the Danes, father of Heorogár, Hróðgár, Hálga (& Ýrse)
heal-gamen|entertainment in the hall
heal-reced|hall-building
heals|neck
heals-béag|neck-ring, collar
heals-gebedda|dear bed-companion, consort
healsian|implore
heal-sittend(e)|hall-sitter
heal-ðegn|hall-thane
heal-wudu|hall-wood
héan|abject, humiliated, wretched, despised
héan(ne)|see héah.
héap|band, troop, company, multitude
heard|hard, strong, brave, hardy, severe
hearde|hard, sorely
heard-ecg|hard of edge
heard-hicgende|brave-minded
Heard-réd|Geatish king, son of Hygelác
hearm|harm, injury, insult
hearm-dæg|evil day
hearm-scaþa|pernicious enemy
hearpe|harp, lyre
heaðerian|restrain, confine
heaðu-|battle.
heaþo-blác|bleak by battle, pale, mortally wounded
Heaðo-Beardan|a Germanic tribe
heaðo-byrne|war-byrnie, mail-coat
heaþo-déor|battle-brave
heaðo-, heaðu-fýr,|battle-fire, deadly fire
heaþo-geong|young (in war)
heaðo-grim(m)|battle-grim, fierce
heaðo-lác|(battle-sport), battle
Heaþo-láf|a man of the Wylfing tribe
heaþo-líðend(e)|war-sailor, sea-warrior
heaðo-maére|renowned in battle
Heaþo-Raémas|a people living in southern Norway
heaðo-raés|storm of battle
heaðo-réaf|war-dress, battle-gear, armour
heaðo-rinc|warrior
heaþo-róf|brave/famed in battle
heaðo-sceard|battle-hacked, notched
Heaðo-Scilfingas|see Scylfingas.
heaðo-síoc|battle-sick, wounded
heaþo-stéap|(steep) towering in battle
heaþo-swát|battle-sweat, blood shed in battle
heaðo-torht|battle-clear, clear (sounding) in battle
heaðo-waéd|war-dress, armour
heaðo-weorc|battle-work, fight
heaðo-wylm|(battle-surge), violent flame
heáþu|indecl., high place
heaðu-sweng|battle-stroke, battle-swing
héawan|hew
ge-héawan|hew, cut (to pieces)
hebban|(heave), raise, lift
hédan|heed, care for
ge-héde|see ge-hégan.
hefene|see heofon.
ge-hégan|hold (a meeting), perform, carry out, achieve
heht|see hátan.
helan|conceal, cover, hide
hel(l)|hell
hell-bend|bond of hell
helm|protection, cover
helm-berend|(helmet-bearer), warrior
Helmingas|the family to which Wealhþéow belongs
help|help
helpan|help
hel-rúne|one skilled in the mysteries of hell, necromancer
Hemming|a kinsman of Offa(?)
Hengest|leader of the (Half-)Danes after Hnæf's death in Frisia
héo (hío)|see hé.
heofon|heaven
heolfor|blood, gore
heolster|hiding-place
heonan|hence
héore|safe, pleasant, good
heoro-, heoru-dréor|(sword-, i.e. ) battle-blood
heoro-dréorig|(sword-)gory, blood-stained
Heoro-gár|Danish king, elder brother of Hróðgár
heoro-gífre|(sword-greedy), fiercely ravenous
heoro-, heoru-grim(m), |(sword-grim), fierce
heoro-hócyhte|(sword-hooked), barbed
heoro-sweng|sword-stroke, sword-swing
heorot|hart, stag
Heorot|the famous hall of the Danish king Hróðgár
Heoro-weard|son of Heorogár
heoro-wearh|accursed foe, savage outcast
heor(r)|hinge
heorte|heart
heorð-genéat|hearth-companion, retainer
heoru|sword
heoðu|hall, precincts
hér|here, hither
here|army, host, troop
Here-beald|Geatish prince, eldest son of Hréðel
here-bróga|war-terror
here-byrne|battle-byrnie
Here-gár|see Heoro-gár.
here-gríma|war-mask, visored helmet
Here-mód|a king of the Danes
here-net|(war-net), mail-coat
here-níð|hostility, violence
here-pád|coat of mail
here-ric|army-rule, war-hero
Here-ríc|uncle of Heardréd(?) (i.e. brother of Hygd)
here-sceaft|battle-shaft, spear
here-sceorp|war-dress, armour
Here-Scyldingas|see Scyldingas.
here-spéd|success in war
here-straél|war-arrow
here-syrce|(battle-sark), shirt of mail
here-waéd|war-dress, armour
here-wæs(t)m|(warlike stature,) martial vigour
here-wísa|army leader
herg (hearh)|a place sacred to a god
herge|see here, herian.
herian|praise
hete|hate, hostility
hete-líc|hateful
hetend|see hettend.
hete-níð|enmity
hete-sweng|hostile blow
hete-þanc|thought of hate
hettend|enemy
Het-ware|a Frankish people on the lower Rhein
hicgean|see hygan.
hider|hither
hige, hyge, |mind, heart, soul
Hige-lác|see Hyge-lác.
hige-maéðu (=-méðu)|weariness of mind, distress of soul
hige-róf|valiant
hige-þíhtig|strong-hearted, determined
hige-þrym(m)|greatness of heart
hild|war, battle
hilde-bil(l)|battle-sword(/-"bill")
hilde-bord|(battle-board, i.e.) shield
Hilde-burh|sister of Hnæf (chief of the Half-Danes), daugher of Hóc, wife of the Frisian king Finn
hilde-cyst|battle-virtue, valour
hilde-déor|brave in battle
hilde-freca|see hild-freca.
hilde-geatwe|war-equipments
hilde-gicel|battle-icicle
hilde-gráp|hostile grasp
hilde-hlæm(m)|crash of battle
hilde-léoma|battle-light
hilde-méce|battle-sword
hilde-mecg|warrior
hilde-raés|storm of battle
hilde-rand|battle-shield
hilde-rinc|warrior
hilde-sceorp|war-dress, armour
hilde-setl|war-seat, saddle
hilde-strengo|battle-strength
hilde-swát|battle-sweat, battle-blood
hilde-túx (=túsc)|battle-tusk
hilde-waépen|war-weapon
hilde-wísa|leader in battle
hild-freca|fighter, warrior
hild-fruma|war-chief
hild-lata|one sluggish in battle, coward
hild-plega|war-play, warfare, battle
hilt|hilt
hilted|hilted
hilte-cumbor|hilt-banner
hindema|last, (hindmost)
hín-fús|eager to get away
híofan|lament
hioro-drync|sword-drink, blood
hioro-serce|(battle-sark), coat of mail
Hiorot|see Heorot.
hioro-weallende|welling fiercely
hit (hyt)|see hé.
hladan|lade, load, heap up, lay
ge-hladan|load
hlæst|freight, load, cargo
hlaéw, hláw|mound, barrow, cave
hláford|lord
hláford-léas|lord-less
hláw|see hlaéw.
hleahtor|laughter, merriment
hléapan|leap, gallop
hléo|cover, shelter, protection, hence protector
hléo-burh|sheltering town, stronghold
ge-hleód|see ge-hladan.
hleonian (hlinian)|lean
hléor-berg|cheek-guard, helmet
hléor-bolster|cheek-cushion, pillow
hléotan|(cast lots), obtain
hléoðor-cwyde|ceremonious speech
hléoþrian|speak, exclaim
hlífian|stand high, tower
hlim-bed(d)|bed of rest
hlið|hill with a hollow
hlíuade|see hlífian.
hlúd|loud
hlyn(n)|sound, din
ge-hlyn(n)|loud sound, din
hlynnan|make a noise, shout, roar
hlynsian|resound
hlytm|lot
hnáh|lowly, mean, poor, illiberal
hnaégan|humble, subdue
ge-hnaégan|lay low, humble, subdue
Hnæf|chief of the (Half-)Danes, brother of Hildeburh, son of Hóc
hnítan|(strike), clash together
Hóc|father of Hildeburh & Hnæf
hof|dwelling, house, court
(ge-)hogode|see (ge-)hycgan.
hoh|mound, hill
hold|loyal, trustworthy
hólinga|in vain, without cause
holm|sea, water
holm-clif|sea-cliff, cliff by the water-side
holm-wylm|surge of the sea
holt|wood, copse
holt-wudu|wood
homer|see hamer.
hond, hond- (gestealla, scolu)|see hand(-).
hond-gemót|hand-meeting, battle
hond-gesella|companion (who is close to one's side), comrade-in-arms
hond-geweorc|handiwork, deed of strength
hond-locen|(locked) linked by hand
hond-raés|hand-fight
Hond-scióh|a Geat warrior, one of the comrades of Béowulf
hond-slyht|counter-blow, return blow by hand
hond-sweng|hand-swing, stroke
hond-wundor|wondrous thing wrought by hand
hongian|see hangian.
hord|hoard, treasure (orig. what is hidden )
hord-ærn|treasure-house
hord-burh|treasure-city
hord-gestréon|stored-up possessions, treasure
hord-máðum|hoard-treasure, jewel
hord-weard|guardian of treasure
hord-wela|hoarded wealth
hord-weorþung|honouring with treasure
hord-wyn(n)|hoard-joy, delightful treasure
horn|horn
horn-boga|horn-bow (i.e. bow 'tipped with horn' or 'curved like a horn')
horn-géap|wide-gabled
horn-reced|gabled hall
hors|horse
hós|troop (of attendants)
hoðma|concealment, grave
hrá|corpse, cadaver, body
Hraédlan, Hraédles|see Hréðel.
hræd-líce|quickly
hræfen|see hrefn.
hrægl|dress, corslet
hræðre|see hreðer.
hrá-fyl(l)|fall of corpses, slaughter
hraþe, hræþe|quickly
hréam|cry, outcry
hréa-wíc|place of corpses
hrefn (hræfn)|raven
Hrefna-wudu,|a forest in Sweden
Hrefnes-holt|a forest in Sweden
hrémig|exulting, boasting
hréoh|rough, fierce, savage, troubled
hréoh-mód|troubled in mind, fierce
hréosan|fall, rush
Hréosna-beorh|a hill in Geatland
hréow|sorrow, distress
hréð|glory, triumph
hreþe|see hraþe.
Hréðel (-aé-, Hraédla)|king of the Geats, father of Hygelác, grandfather of Béowulf
hreðer|breast, heart
hreþer-bealo|(heart-bale), distress
Hréþling|son of Hréþel
Hréð-men|a name for the Geats
Hréð-ríc|a son of Hróðgár
hréð-sigor|glorious victory
hrínan|touch, reach
hrimge/hrinde|covered with frost
hring|ring (ornament)
hringan|ring, resound
hring-boga|coiled creature (dragon)
Hring-Dene|see Dene.
hringed|(pp.), formed of rings
hringed-stefna|ring-prowed ship
hring-íren|ring-iron, iron rings (of mail-coat)
hring-maél|ring-marked, i.e. (sword) adorned with a ring, (or, perhaps, ring-weapon)
hring-naca|ring-prowed ship
hring-net(t)|ring-net, coat of mail
hring-sele|ring-hall
hring-weorðung|ring-adornment
hroden|adorned, decorated
hróf|roof
hróf-sele|roofed hall
Hrones-næs(s)|a headland on the coast of Geatland
hron-fisc|whale(-fish, cp. Ger. Walfisch)
hron-rád|whale-road, ocean
hrór|agile, vigorous, strong
Hróð-gár|king of the Danes, son of Healf-Dane, lord of Heorot
Hróð-mund|a son of Hróðgár
hróðor|joy, benefit
Hróþ-ulf|son of Hálga, nephew of Hróðgár
Hrunting|Unferð's sword
hruron|see hréosan.
hrúse|earth, ground
hrycg|back, ridge
hryre,|fall, death
hryssan (hrissan)|shake, rattle (intr.)
hú|conj., how
Húgas|a name applied to the Franks
hund|dog, hound
hund, num.|hundred
Hun-ferð|see Un-ferð.
Hún-láfing|Hengest's sword? or perh. a warrior in Hengest's band (son of Húnláf)?
húru|indeed, at any rate, verily, however
hús|house
húð|spoils, booty, plunder
hwá|who, what
ge-hwá|each (one)
hwan|see hwá.
hwanan, -on|whence
hwár|see hwaér.
hwata, -e, -um|see hwæt.
hwæder|see hwyder.
hwaér|conj., where, anywhere
ge-hwaér|everywhere, on every occasion
hwæt|brisk, vigorous, valiant
hwæt|see hwá.
hwæt|what, lo, behold, well
hwæðer|(whether), which of two
ge-hwæþer|either, each (of two), both
hwæþer|whether
hwæþre, hwæþere|however, yet
hwearf-líc|active(?), trusty(?)
ge-hwelc|see ge-hwylc.
hwéne|a little, somewhat
hweorfan|turn, go, move about
ge-hweorfan|go, pass
hwergen|somewhere
hwettan|whet, urge, incite
hwíl|while, time, space of time
hwít|white, shining
hworfan|see hweorfan.
hwyder|whither
hwylc|which, what
ge-hwylc|each, every (one)
hwyrfan|move about
hwyrft,|turning, motion, going
hycgan|think, purpose, resolve
ge-hycgan|resolve
hýdan|hide
ge-hygd|thought
Hygd|wife of Hygelác
hyge|see hige.
hyge-bend|mind's bond, heart-string
hyge-giómor|sad in mind, sad at heart
hyge-méðe|wearying the mind
hyge-sorh|heart-sorrow
hyht,|hope, solace
ge-hyld|protection
hyldan|incline, bow down
hyldo|favour, grace, loyalty, friendship
hylt|see hilt.
hýnan|humble, ill-treat, injure
hýnðu|humiliation, harm, injury
hýran|hear
ge-hýran|hear, learn
hyrde|((shep)herd), guardian, keeper
hyrst|ornament, accoutrement
hyrstan|adorn, decorate
hyrsted-gold|fairly-wrought gold
hyrtan|encourage
hyse|youth, young man
hyt(t) (hit(t))|heat
hýð|harbour
hýð-weard|harbour-guardian
ic|I
ídel|idle, empty, unoccupied
ídel-hende|empty-handed
ides|woman, lady, queen
in|in
in(n)|dwelling, lodging
inc, incer|see þú.
in-fród|very old and wise
in-gang|entrance
In-geld|prince of the Heaðo-Bards, son of Fróda
in-genga|invader
in-gesteald|house-property, possessions in the house
Ing-wine|(Ing's friends), Danes
inn|see in
innan|(from) within, inside
innan-weard|inward, interior
inne|within, inside
inne-weard|inward, interior
inwid-sorh|see inwit-sorh.
inwit-feng|malicious grasp
inwit-gæst|malicious (stranger or) foe
inwit-hróf|evil ( or enemy's) roof
inwit-net(t)|net of malice
inwit-níð|enmity, hostile act
inwit-scear|malicious slaughter
inwit-searo|malicious intrigue/cunning
inwit-sorh|evil care/sorrow
inwit-þanc|hostile purpose
ge-íode|see ge-gán.
Iofor|see Eofor.
iogoð|see geogoð.
ió-méowle|old woman or wife
íren|iron, sword
íren|of iron
íren-bend|iron band
íren-byrne|iron byrnie
íren-heard|iron-hard
íren-þréat|host having iron armour, armed troop
is|see eom.
ís|ice
ísern-byrne|iron byrnie
ísern-scúr|iron shower (or arrows)
ís-gebind|icy bond
ísig|icy, covered with ice
iú|see geó.
iú-mon(n)|man of old
lá|lo, indeed
lác|gift, offering
ge-lác|motion, play
lácan|move quickly, fly
lád|water-course
ge-lád|difficult passage/path across water liable to be rendered impassable by flooding
láf|what is left as an inheritance, heirloom
ge-lafian|refresh, lave
lagu|sea, lake, water
lagu-cræftig|sea-skilled, experienced as a sailor
lagu-straét|sea-road (-street)
láh|see léon.
land|land
land-búend|land-dweller, earth-dweller
land-fruma|prince of the land, king
land-gemyrce|land-boundary
land-geweorc|land-work
land-waru|people of the land
land-weard|land-guard, coast-guard
lang(e)|see long(e).
ge-lang|at hand, dependent on (æt)
langað|longing
lang-twídig|granted for a long time, lasting
lár|(lore), instruction, counsel, precept, bidding
lást|track, footprint
láð|hateful, grievous, hostile (used as subst.: foe)
láð-bite|grievous/hostile bite, wound
láð-getéona|loathly spoiler, evil-doer
láð-líc|loathly, hideous
laédan|lead, bring
laéfan|leave, leave behind
laén-dagas|transitory (loaned) days
laéne|(loaned) transitory, perishable, perishing
læng|see longe.
laéran|teach
ge-laéran|teach, advise, persuade
laés|see lýt.
laésest, laéssa|see lýtel.
laéstan|serve, stand by
læt|sluggish, slow
laétan|let, allow
léaf|leaf
léafnes-word|word of leave, permission
léan|reward, requital
léan|blame, find fault with
léanian|requite, recompense (somebody for something)
léas|devoid of, without
léas-scéawere|deceitful observer, spy
lég(-)|see líg(-).
leger|lying, place of lying, lair
leger-bed(d)|bed, bed of death, grave
lemman (lemian) |lame, hinder, oppress
leng(e), lengest|see longe.
lenge|belonging, at hand
ge-lenge|belonging to (dat.)
lengra|see long.
léod|man, member of a tribe/nation
léod-bealo|harm to a people, great affliction
léod-gebyrgea|protector of a people, prince
léod-burg|town
léod-cyning|king of a people
léod-fruma|prince of a people
léod-hryre|fall (of a people or) of a prince, national calamity
léod-sceaða|harmer of a people, people's enemy
léod-scipe,|nation, country
léof|dear, beloved
leofað|see libban.
léof-líc|precious, admirable
léogan|lie, belie
ge-léogan|deceive, play false
léoht|light
léoht|light, bright, gleaming
léoma|light, gleam, luminary
leomum|see lim.
léon|lend
leornian|learn, devise
léoð|song, lay
leoðo-cræft|skill of limbs (hands)
leoðo-syrce|(limb-sark), coat of mail
lettan|(let), hinder
libban, lifgan|live
líc|body (generally living)
ge-líc|(a)like
licgan|lie, lie down, lie low, lie dead
ge-licgan|subside
líc-homa|body
lícian|please
líc-sár|bodily pain, wound
líc-syrce|(body-sark), coat of mail
lid-man(n)|seafarer
líf|life
líf-bysig|struggling for life, in torment of death
líf-dæg|???
líf-fréa|lord of life (God)
líf-gedál|parting from life, death
líf-gesceaft|life (as ordered by fate)
lifige, lifigende|see libban.
líf-wraðu|life-protection
líf-wyn(n)|joy of life
líg,|flame, fire
líg-draca|fire-dragon
líg-egesa|fire-terror
lige-torn|pretended injury/insult
ligge|see líg.
líg-ýð|wave of flame
lim|limb, branch (of tree)
limpan|happen, befall
ge-limpan|happen, come to pass, be forthcoming
lind|(linden), shield (made of linden-wood)
lind-gestealla|shield-companion, comrade in battle
lind-hæbbend(e)|shield-bearer (-having), warrior
lind-plega|shield-play, battle
lind-wiga|shield-warrior
linnan|part from, lose
liss|kindness, favour, joy
list|skill, cunning
lídan|go (by water), traverse
líðe|protective
liþend-dæg|seafaring day(s)
líð-waége|cup of strong drink
líxan|shine, glitter, gleam
locen|see lúcan.
lócian|look
lof|praise, glory
lof-daéd|praiseworthy (glorious) deed
lof-georn|eager for glory (fame)
lóg, lógon|see léan.
ge-lóme|frequently
lond(-)|see land(-).
lond-riht|land-right, privileges belonging to the owner of land, domain
long|long
ge-long|see ge-lang.
longe|long
long-gestréon|(long-accumulated,) old treasure
long-sum|long, long-lasting, enduring
losian|(be lost), escape, get away safely
lúcan|lock, intertwine, link
lufen|joy, comfort(?)
lufian|love, treat kindly
luf-tácen|token of love
lufu|love
lungor|swift
lungre|quickly, forthwith, straightway
lust|joy, pleasure
ge-lýfan|believe in, trust
lyfað, lyfde|see libban.
lyft|air, sky
lyft-floga|air-flier
lyft-geswenced|driven by the wind
lyft-wyn(n)|air-joy, joyous air
lÿhð|see léan.
lystan|desire
lýt|little, small number
lýtel|little, small
lýt-hwón|very little, not at all
má|more
mádma(s), -e, -um|see máð(ð)um.
maga|son
magan|can, may
mágas, -a, -um|see maég.
máge (maége)|kinswoman (mother)
mago|son
mago-driht|band of young followers
mago-rinc|young warrior
mago-ðegn|young retainer, young thane
man(n), man-|see mon(n), mon-.
mán|crime, guilt, wickedness
mán-for-daédla|wicked destroyer, doer of evil deeds
manian|admonish, urge
manig|see monig.
man-líce|manfully, nobly
mán-scaða|wicked ravager, wicked criminal
mára|see micel.
maþelian|speak, discourse, make a speech
máðm-aéht|precious property, treasure
máþm-gestréon|treasure
máð(ð)um|precious/valuable thing, treasure
máðþum-fæt|precious vessel
máðþum-gifu|treasure-giving
máððum-sigle|precious jewel
máðþum-sweord|precious sword
máððum-wela|wealth of treasure
maég|kinsman, blood-relative
maég-burg|kinsmen, kindred, clan
mægen|might, strength, power, main
mægen-ágende|strong, might, powerful
mægen-byrþe(n)|mighty (burthen,) burden
mægen-cræft|strength
mægen-ellen|mighty valour
mægen-fultum|powerful help
mægen-raés|mighty impetus
mægen-strengo|great strength
mægen-wudu|(main-wood, mighty wood), mighty spear
mægð|maid(en), girl, woman
maégþ|tribe (orig. aggregate of blood-relatives), nation, people
maég-wine|kinsman and friend
maél|time, suitable time, occasion
maél-cearu|care/sorrow of the time
maél-gesceaft|alloted time, destiny, fate
maénan|speak of, utter, relate, complain of
ge-maénan|mention, complain
ge-maéne|common, in common, mutual, shared
mænigo|see menigeo.
maére|famous, glorious, illustrious
maérðo|fame, glory, glorious deed
mæst|mast
maést|see micel.
maéte|moderate, insignificant, small
mé|see ic.
méagol|earnest, forceful, hearty
mearc|mark, limit
mearcian|mark, make a mark
mearc-stapa|('mark-'haunter), wanderer in the waste borderland
mearh|horse, steed
mearn|see murnan.
mec|see ic.
méce|(long, double-edged) sword
méd|meed, reward
ge-méde|agreement, consent
medo, medu,|mead, (honey wine)
medo-ærn|mead-hall
medo-benc|mead-bench
medo-ful(l)|(filled) mead-cup
medo-heal(l)|mead-hall
medo-stíg|path to the mead-hall
medu-dréam|mead-joy, festivity
medu-seld|mead-house
melda|informer
meltan|melt
ge-meltan|melt
mene|necklace
mengan|mix, mingle, stir up
menigeo|multitude, a great many
meodo-setl|mead-(house-)seat, i.e. hall-seat
meodo-wong|plain near the mead-hall
meodu-benc, -heal(l)|see medo-.
meodu-scenc|mead-vessel, -cup
meoto, ap. of me(o)tu|meditation, contemplation, thought(s)
meotod-|see metod-.
méowle|woman
mercels|mark, aim
mere|mere, lake, pool, sea
mere-déor|sea-beast
mere-fara|seafarer
mere-fisc|sea-fish
mere-grund|bottom ('ground')of a mere
mere-hrægl|sea-garment, sail
mere-líðend(e)|seafarer
mere-straét|sea-path
mere-strengo|strength in the sea
mere-wíf|mere-woman, water-witch
Mere-wíoing|Merovingian (i.e. king of the Franks)
mergen|see morgen.
ge-met|measure, faculty, power
ge-met|fit, proper, meet
metan|measure, traverse
métan|meet, find, come upon
ge-métan|meet, find
ge-méting|meeting, encounter
metod|god, deity (perh. orig. measurer (of fate), governor)
metod-sceaft|decree of fate, death
meðe|weary, exhausted
meþel (mæþel) |council, meeting
meðel-stede|place of assembly, battle-field
meþel-word|formal word
micel|great, large, much
mid|with
middan-geard|middle dwelling (yard), world, earth
midde|in the middle
middel-niht|middle of the night
miht|might, power, strength
mihtig|mighty
milde|generous, magnanimous
míl-gemearc|measure by miles
milts|kindness
mín|mine
missan|miss (a mark)
missére|half-year
mist-hliþ|misty hill, cover of darkness
mistig|misty, dark
mód|mind, spirit, heart
mód-cearu|sorrow of the soul
mód-gehygd|thought
mód-geþonc|thought(s), mind
mód-giómor|sad at heart
módig|high-spirited, courageous, brave
módig-líc|brave, gallant
mód-lufu (-lufe) |heart's love, affection
módor|mother
mód-sefa|mind, spirit, heart, character
mód-þracu|impetuous courage, daring
mód-þrýðo, Þrýðo|probably a description of Offa's queen
mon(n)|man
móna|moon
mon-cyn(n)|mankind
mon-dréam|human pleasures, joys of man
mon-dryhten|(liege) lord
ge-mong|mingling together, throng, troop
monig|(sg.) many a, (pl.) many
mon-ðwaére|courteous, gracious, cordial, agreeable, gentle, kind, humane
mór|moor, marsh, waste land, desert
morgen|morning, morrow
morgen-ceald|morning-cold
morgen-léoht|morning-light, sun
morgen-long|lasting the morning
morgen-swég|morning-cry
morgen-tíd|morning (time)
mór-hop|hidden or secret place/enclosure in a moor
morna|see morgen.
morð-bealu|murder (-bale)
morðor|murder, slaying
morþor-bealo|murder, slaughter
morþor-bed(d)|bed of death (by violence)
morþor-hete|murderous hate/hostility
mótan|may, have opportunity, be allowed
ge-munan|bear in mind, remember, think of, be mindful of
mund|hand
mund-bora|protector, guardian
mund-gripe|hand-grip
murnan|mourn, be sad
múþa|mouth, opening, (door)
múð-bona|one who destroys with the mouth, devourer
ge-mynd|remembrance, memorial
myndgian|(recollect), remind
ge-myndgian|call to mind
ge-myndig|mindful (of), intent (on)
myne|mind, desire
ge-myne|see ge-munan.
myntan|intend, think
myrce|dark, murky
myrð(u)|disturbance, trouble, affliction
ná|see nó.
naca|boat, ship
nacod|naked, bare
náh|see ágan.
nalas, nalæs, nales, nallas, nalles|see nealles.
nam, náman|see niman.
nama|name
nán, pron.|no
nát|see witan.
nát-hwylc|some (one), a certain (one)
næbben|see habban.
Nægling|Béowulf's sword
næfne|see nefne.
naéfre|never
ge-naégan|(approach), assail, attack
nægl|nail
nægl(i)an|nail
naénig, pron.|no-one, none
naére, naéron, næs (=ne wæs)|see eom.
næs|by no means
næs(s)|headland, bluff, ness
næs-hlið|(slope of) headland
ne|not
néah|near, nigh
ge-neahhe|sufficiently, abundantly, frequently
nealles|not at all
néan|from near, near
néar|see néah.
nearo|narrow
nearo|straits, difficulty, distress
nearo-cræft|art of rendering access difficult, (lit., 'narrow-craft')
nearo-fáh|cruelly hostile
nearo-þearf|severe distress
nearwe|narrowly, closely
nearwian|press (hard)
nefa|nephew
néh|see néah.
ge-nehost|see ge-neahhe.
nelle|see willan.
nemnan|name, call
nemne|see nefne.
néod-laðu|desire
néon|see néan.
néosan, néosian|seek out, inspect, go to, visit, attack
néotan|make use of, enjoy
neowol|precipitous, steep
nerian|save, protect
ge-nesan|be saved, survive, get safely through
néðan|venture (on)
ge-néþan|venture (on)
nicor|water-monster, ("nicker" (arch.))
nicor-hús|abode of water-monsters
níd-gripe|forceful/coercive grip
nið-gripe|hostile, evil grip
níehsta|see néah.
nigon|nine
niht|night
niht-bealu|night-evil
niht-helm|cover of night
niht-long|lasting a night
niht-weorc|night-work
niman|take, seize
ge-niman|take, seize, take away
níod|desire, pleasuer
níos(i)an|see néosan.
nioðor|see niþer.
níowe|see níwe.
ge-nip|darkness, mist
nípan|grow dark
nis|see eom.
níð|(ill-will, envy), violence
níð-draca|hostile/malicious dragon
niþer|down(ward)
níð-gæst|malicious (stranger or) for
níþ-geweorc|hostile deed, fight
níþ-grim(m)|grim, cruel
níð-heard|violence-hard(ened), brave in battle(?)
níð-hédig|hostile
níð-sele|hostile/battle hall
niþðas|men
níð-wundor|fearful wonder, portent
níwe|new
(ge-)níwian|renew
níw-tyrwed|new-tarred
nó|not at all, not, never
ge-nóg|enough, abundant, many
nolde|see willan.
nóm|see niman.
nón|ninth hour (=3pm)
norð|north(wards)
Norð-Dene|see Dene.
norþan-wind|north wind
nose|projection, promontory, cape
nóðer|nor, and not
nú|now
nýd|necessity, compulsion, distress
(ge-)nýdan|compel, force
nýd-bád|enforced contribution, toll
nýd-gestealla|comrade in need, i.e. in battle
nýd-wracu|violent persecution, dire distress
nýhsta|see néah.
nyman|see niman.
nyllan|see willan.
nymþe|unless, if--not
nyt(t)|use, office, duty, service
nyt(t)|useful, beneficial
ge-nyttian|use, enjoy
nyðer|see niþer.
of|from (motion, direction)
ófer|bank, shore
ofer|over, above
ofer-cuman|overcome
ofer-éode|see ofer-gán.
ofer-fléon|flee from (acc.)
ofer-flítan|over come (in a contest)
ofer-gán|pass over, traverse, overrun
ofer-helmian|overhang, overshadow
ofer-hígian|overtake, overpower
ofer-hycgan|despire, scorn
ofer-hygd|pride, arrogance
ofer-mægen|superior force
ofer-máð(ð)um|fabuluous treasure
ofer-sécan|overtax, put to too severe a trial
ofer-séon|(oversee), look on
ofer-sittan|abstain from, forego (the use of), 'sit out'
ofer-swimman|swim over, cross over (water)
ofer-swýðan|overpower, overcome
ofer-weorpan|fall (over), stumble (elsewhere trans.)
Offa|king of the (continental) Angles
of-ferian|carry off
of-gyfan|give up, leave
of-laétan|leave, relinquish
ofost|haste, speed
ofost-líce|speedily, in haste
of-scéotan|shoot (dead)
of-sittan|sit upon
of-sléan|slay, kill (off)
oft|oft(en)
of-téon|deny, deprive
of-þyncan|of person & gen. of thing, displease
Óht-(h)ere|son of the Swedish king Ongenþéow
ó-hwaér|anywhere
ombeht|servant, officer
ombiht-þegn|servant, attendant
ómig|rusty
on|on
on-arn|see on-irnan.
on-beran|harm, weaken, diminish
on-bídan|wait
on-bregdan|swing open (trans.)
oncer-|see ancor-.
on-cirran|turn, change (trans.)
on-cnáwan|know, recognise, perceive
on-cweðan|answer
on-cýð(ð)|grief, distress
ond|and
ond-hweorfan|turn (intr.) against
ond-léan|see and-léan.
ond-long|see and-long.
on-draédan|dread, fear
on-drysne|terrible, awful
Onela|king of the Swedes, son of Ongenþéow
ónettan|hasten
on-findan|find, find out, discover, perceive
on-fón|receive, take
on-geador|together
on-géan|opposite
Ongen-þéow|king of the Swedes
on-geomor|very sad, mournful
on-ginnan|begin, undetake
on-gitan, -gytan|perceive, see, hear, understand
on-hréran|stir up, arouse
on-irnan|give way, spring open
on-laétan|loosen, release
on-léon|lend
on-lícnes(s)|likeness
on-lúcan|unlock, disclose
on-médla|arrogance, presumption
on-munan|consider worthy of, consider fit for
on-sacan|resist, contest, fight (dat., against)
on-saéce|see on-sécan.
on-saége|attacking, assailing, fatal(?)
on-saélan|untie, loosen, disclose
on-sécan|exact (something from someone), deprive (somebody of someting)
on-sendan|send, send away
on-sittan|dread
on-sponnan|unfasten
on-springan|spring asunder
on-stellan|institute, bring about
on-swífan|swing, turn (trans.)
on-sýn|see an-sýn.
on-tyhtan|incite, impel
on-ðéon|prosper, thrive
on-wacian|to watch over
on-wacnian|awake (intr.)
on-wadan|enter, take possession of
on-wæcnan, pret. onwóc, VI|awake(n) (intr.)
on-weald|power, possession
on-windan|unwind, loosen
on-wóc|see on-wæcnan.
open|open
openian|open (trans.)
ór|beginning, origin
orc|cup, pitcher
orc-néas|Evil Spirits, (sea?) monsters, zombies(?), draugr(??)
ord|point
ord-fruma|leader, chief
Ord-láf|a Danish warrior
óret-mecg|warrior
óretta|warrior
oreðe(s)|see oruð.
or-leahtre|blameless
or-lege|war, battle, strife
orleg-hwíl|time of war, fight
or-þanc|ingenuity, skill
oruð|breath
or-wearde|without guardian
or-wéna|despairing (of, gen.)
Ós-láf|a Danish warrior
oð|until
oþ-beran|bear (off)
oð-éode|see oð-gán.
óðer|other
oð-ferian|bear away
oð-gán|went away, escaped
oððe|or
oð-wítan|reproach, blame
ówer|see ó-hwaér.
ó-wiht|anything, aught
ge-rád|skilful, apt
raécan|reach (out)
ge-raécan|reach, hit
raéd|advice, counsel, help
raédan|(counsel), provide for, rule, control
raéd-bora|counselor
raédend|ruler (=god)
raés|rush, onslaught, storm
raésan|rush (upon)
ge-raésan|rush (against)
ræst|rest, resting-place, bed
raéswa|(counselor), prince, leader
rand|see rond.
rand-wiga|(shield)-warrior
rásian|explore
raþe|see hraþe.
réafian|rob, plunder, rifle
réc,|smoke
reccan|narrate, tell, unfold
reccan|heed, care (for, gen.)
reced|building, hall
regn-heard|wondrously strong
regnian, rénian|prepare, adorn
ren-weard|guardian of the house
réoc|fierce, savage
réön|see rówan.
reord|speech, voice
reordian|speak, talk
ge-reordian|prepare a feast
réotan|weep, make a noise in grief, roar
rest|see ræst.
restan|rest
réóte|joy, cheefulness
réþe|fierce, cruel, furious
ríce|kingdom, realm, rule
ríce|powerful, mighty, of high rank
ricone (recene)|quickly, at once
rícsian|rule, hold sway
rídan|ride
ge-rídan|ride up to
rídend|rider, horseman
riht|right, what is right
rihte|rightly
rinc|man, warrior
riodan|see rídan.
ríxian|see rícsian.
rodor|sky, heaven
róf|renowned, brave, strong
rond|boss of shield
rond-hæbbend(e)|shield-bearer (-having), warrior
rówan|row, move across water
rúm|room, space
rúm|roomy, spacious, large
rúm-heort|large-hearted, noble-spirited
ge-rúm-líce|at a distance, far away
rún|(rune)
rún-stæf|runic letter
rún-wita|confidant, trusted counselor, knower of runes (/secrets)
ryht|see riht.
(ge-)rýman|clear, vacate, yield
ge-rysne, (-risne)|proper, becoming
sacan|contend, fight
ge-sacan|contend, fight
sacu|strife, fighting
ge-saca|adversary, opponent, foe
ge-sacu|contention, enmity
sadol|saddle
sadol-beorht|saddle-bright
sál|rope
sálum|see saél.
samod|together
sand|sand, shore
sang|song, cry
sár|(sore), pain, wound
sár|sore, grievous, bitter, painful
sáre|sorely, grievously, painfully
sárig|sad, mournful
sárig-ferð|sad at heart
sárig-mód|sad-hearted, low-spirited
sár-líc|painful, sad
sáwl-berend|(soul-bearer), human being
sáwol|soul, spirit, life
sáwol-léas|lifeless
sáwul-dríor|life-blood
saé|sea
saé-bát|sea-boat, ship
sæc(c)|fighting, battle, conflict, quarrel
sæce|see sacu.
saé-cyning|sea-king
sæd|satiated with, having had one's fill of, wearied with
saédan, saéde|see secgan.
saé-déor|sea-beast
saé-draca|sea-serpent
saégan|law low, slay
saé-géap|curved (or spacious) (for use on the sea)
saé-genga|sea-goer, i.e. ship
saégon|see séon.
saé-grund|bottom of the sea
sæl|hall
saél|time, proper time, opportunity, season
saé-lác|sea-booty
saé-lád|sea-journey, voyage
saélan|fasten, moor
ge-saélan|befall, chance, turn out favourably
sæld|hall
saé-líðend|sea-farer
sæltimbred|timbered-hall
saélð|happiness, joy, good fortune
saé-man(n)|sea-man
saé-méþe|sea-weary
saémra|inferior, worse, weaker
saé-næs(s)|(sea-)headland
saéne|slow
saé-rinc|sea-man, -warrior
saé-síð|sea-journey, voyage
saé-weal(l)|sea-wall, shore
saé-wong|plain by the sea
saé-wudu|(sea-wood), ship
saé-wylm|sea-welling, billow, ocean wave, surging of (ocean) water
scacan|hasten, pass, depart
ge-scád|distinction, discrimination
ge-scádan|decide
scadu-helm|cover of shadow (night), darkness
scami(g)an|be ashamed
scaþa|see sceaþa.
ge-scæp-hwíl|fated time (hour)
sceacen, sceaceð|see scacan.
scead|pl. sceadu, shade(s), shadow
sceáden-maél|(ornamented with distinctive or branching patterns, i.e.) damascened/pattern-welded sword
sceadu-genga|walker in shadow
ge-sceaft|(creation, abstr., & concr. collect.), world
scealc|(servant), retainer, warrior, man
ge-sceap|creation, creature, shape, form
sceapen|see scyppan.
scearp|sharp, acute, clever
scéat|corner, district, region, lap
sceat(t)|property, money, treasure
sceaþa|one who does harm, enemy
scéawian|look at, view, examine, see, behold
Scede-land (=Sceden-), n.|see Sceden-íg
Sceden-íg|name of the southernmost part of the Scandinavian peninsula (Skane), applied to the Danish realm
Scéfing|appellation of Scyld ('son of Scéf')
sceft (sceaft)|shaft (of arrow)
scel|see sculan.
scencan|pour out, give to drink
scenn|sword-guard (?), plate of metal on handle of sword(?)
ge-sceód|see ge-sceðþan.
scéotan|shoot
ge-scéotan|(shoot), dart to, hasten to
scéotend|shooter (archer), warrior
scepen|see scyppan.
sceran|(shear), cut through
sceþðan, VI|injure, harm
ge-sceþðan|injure, harm
scildig|see scyldig.
scild-weall|shield-wall, phalanx(?)
scild-wiga|see scyld-.
scile|see sculan.
scínan|shine
scinna|spectre, evil spirit, demon, ("shine")
scionon|see scínan.
scip|ship, boat
ge-scipe|fate
scip-here|ship-army, naval force
scír|bright, resplendent, glorious, clear
scireð|see sceran.
scír-ham|in bright armour
(ge-)scód|see (ge-)sceþðan.
scofen|see scúfan.
scop|poet, singer, bard
(ge-)sc(e)óp|see (ge-)scyppan.
scrífan|decree, adjudge, impose (sentence)
ge-scrífan|decree, assign
scríðan|glide, slink, slither, wander, move, stride
scucca|demon, devil
scúfan|shove, push, move forward
sculan|must, ought, is to
scúr-heard|shower-hard, resilient in the storm of battle
scyld|shield
scyldan|protect, shield
scyld-freca|(shield-)warrior
scyldig|guilty
Scyld|mythical Danish king
Scyldingas|(descendants of Scyld, members of Danish dynasty), Danes
scyle|see sculan.
Scylfingas (Scilf-)|(Swedish dynasty), Swedes
scyndan|hasten
scýne|beautiful, fair
scyp|see scip.
scyppan|create, shape, make
ge-scyppan|create
scyppend|creator (god)
scýran (scíran)|clear up, settle
sealma (selma) |bedstead, bed, couch
sealo-brún|(sallow- or) dark-brown
sealt|salt
searo|contrivance, skill, cleverness, art, cunning
searo-bend|cunningly wrought band/clasp
searo-fáh|cleverly decorated
searo-gim(m)|cleverly-cut gem
searo-grim(m)|fierce in battle
searo-hæbbend(e)|(armour-having), armoured warrior
searo-net(t)|armour-net/battle-net, mail-coat
searo-níð|cunning enmity, treacherous quarrel
searo-þonc|ingenuity, skill, art
searo-geþræc|pile of well-wrought things, precious heap
searo-wundor|curious wonder, wonderful artefact/device
seax|sax (knife), dagger, knife, short sword
sécan|seek
ge-sécan|seek
secce|see sæc(c).
secg|man
secg|(short, thrusting) sword, ("sedge")
Secgan|a Germanic (coastal) tribe
secgan|say, tell
ge-secgan|say, tell
sefa|mind, heart, spirit
séft|see sófte.
ge-ségan(-on)|see ge-séon.
segen|see segn.
segl|sail
segl-rád|sail-road, i.e., sea, lake
segn|banner, standard
sel|see sæl.
sél (noun)|see saél.
sél|comp., better
ge-selda|(one of the same dwelling), companion, comrade
seldan|seldom
seld-guma|hall-man, retainer
sele|hall
sele-dréam|joy of the hall
sele-ful(l)|(filled) hall-cup
sele-gyst|visitor (guest) to a hall
sele-raédend(e)|hall-counselor, -ruler
sele-rest|bed (rest) in a hall
sélest|see gód.
sele-þegn|hall-thane, chamberlain
sele-weard|hall-warden, -guardian
self|self
sélla|see gód.
sellan|give
ge-sellan|give, make a present of
sel-líc, syl-líc|strange, wonderful
sélra|see gód.
semninga|straightaway, at once
sendan|send
séo|see sé.
séoc|sick, ill, weakened
seofon|seven
seolfa|see self.
seomian|rest, lie, remain, hover, hang
séon|look
ge-séon|see, behold, perceive
seonu|sinew
séoðan|seethe, boil, cause to well up, brood over
seoððan|see siððan.
séow(i)an|sew, put together, link
ses(s)|seat
sétan|see sittan.
setl|seat
settan|set
ge-settan|set, establish
sex-ben(n)|dagger-(seax-)wound
sib(b)|kinship, friendship, peace
sib-æðeling|related noble
sibbe-gedriht|band of kinsmen
síd|large, spacious, broad, great
síde|widely
síd-fæþme|roomy
síd-rand|broad shield
síe|see eom.
síe|see sé.
siex-bennum|see sex-ben(n).
sig|see eom.
sígan|sink, fall
ge-sígan|sink, fall
sige-beorn|victorious warrior
sige-drihten|victorious lord
sige-éadig|victory-blest, victorious
Sige-ferð|one of Hnæf's warriors (of the tribe of the Secgean)
sige-folc|victorious/gallant people
sige-hréð|glory of victory
sige-hréþig|victorious, triumphant
sige-hwíl|time of victory, victory
sigel|luminary, sun
sige-léas|without victory, of defeat
Sige-mund|son of Wæls, uncle (and father) of Fitela
sige-róf|victorious, illustrious
Sige-Scyldingas|see Scyldingas.
sige-þéod|victorious/glorious people
sige-waépen|victory-weapon
sigle|jewel, brooch, necklace
sigor|victory
sigor-éadig|victorious
sín|his, her, its, theirs
sinc|treasure, jewels, something precious, ornament
sinc-fæt|precious cup, coastly object
sinc-fág|richly decorated
sinc-gestréon|treasure
sinc-gifa|treasure-giver
sinc-máðþum|treasure, jewel
sinc-þego|receiving of treasure
sin-fréa|great lord
sin-gál|continual
sin-gála, sin-gáles,|continually, always
singan|sing, ring (forth)
sin-here|(huge) sacred grove
sin-niht|perpetual night/darkness
sint|see eom.
sío|see sé.
sioloð|water, sea (?)
siomian|see seomian.
sittan|sit
ge-sittan|sit down (ingress.)
síð|going, journey, voyage
síð|comp., later
ge-selda|(one of the same dwelling), companion, comrade
ge-síð|companion, comrade, follower, retainer
síðast, síðest|latest, last
síð-fæt|adventure, expedition
síð-from|eager to depart
síðian|go, journey
siððan|since
sixtig|sixty
slaép|sleep
slaépan|sleep
sléac|slow, slothful
sléan|strike
ge-sléan|achieve (or bring about) by fighting
slítan|tear, rend, (slit)
slíðe|severe, dangerous, terrible
slíðen|cruel, dire
ge-slyht|battle, conflict
smið|smith, worker of metals
snadan|cut off, prevent?
snel(l)|quick, bold, brave
snel-líc|quick, brave
snot(t)or|wise, prudent, clever
snotor-líce|wisely, prudently
snúde|quickly, straightaway
snyrian|hasten
snyttru|wisdom, discernment, skill
sócn|(seeking), persecution, visitation
sófte|softly, gently, pleasantly
sol|mud, wet sand
somod|see samod.
sóna|immediately, at once, (soon)
sorg(-)|see sorh(-).
sorgian|sorrow, grieve, care
sorh|sorrow, grief, trouble
sorh-cearig|sorrowful, sad
sorh-ful(l)|sorrowful
sorh-léas|free from care, sorrowless
sorh-léoð|song of sorrow, dirge
sorh-wylm|surging (welling) sorrow / care
sóð|true
sóð|truth
sóð-cyning|king of truth, god
sóðe|truly, faithfully
sóð-fæst|true, righteous (cp. Lat. 'iustus')
sóð-líce|truly, verily, faithfully
specan|see sprecan.
spéd|success
spel(l)|tale, story, message
spíwan|spew, vomit
spówan|succeed, speed
spraéc|speech, language
sprecan|speak
ge-sprecan|speak
springan|spring, bound, burst forth, spread
ge-springan|spring forth, arise
stán|stone, rock
stán-beorh|stone-barrow
stán-boga|(stone-bow), stone arch
stán-clif|rocky cliff
standan|stand, continue in a certain state
ge-standan|stand, take up one's stand
stán-fáh|adorned with stones, paved
stán-hlið|rocky hill with a hollow
stapol|post, pillar
starian|gaze, look, (stare)
staél|place, position
staélan|(lay to one's charge), avenge
stéap|steap, high, towering
stearc|stark, stiff, strong, hard
stearc-heort|stout-hearted
stede|stead, place
stefn|stem, prow
stefn|period, time
stefn|voice
stépan|raise, exalt
ge-stépan|advance, support
steppan|step, stride, march
ge-steppan|step, walk
stíg|path
stígan|go, step, go up, mount
ge-stígan|go (up), set out
stille|still, fixed
stincan|to smell (something)
stíð|firm, strong, hard
stíð-mód|stout-hearted, firm
stondan|see standan.
stóp|see steppan.
storm|storm
stów|place
straél|arrow
straét|street
strang|strong
stréam|stream, current (pl.: sea, body of water)
strégan|strew, spread
strengel|chief, ruler
strengest|see strang.
strengo|strength
ge-stréon|wealth, treasure
strong|see strang.
strúdan|plunder, ravage, spoil
ge-strýnan|acquire, gain
stund|time
stýle|steel
stýl-ecg|steel-edged
stýran|(steer), restrain
styrian|stir up
styrman|storm, shout, roar, rage
suhterge-fæderan|nephew (brother's son) and (paternal) uncle
sum|some (one), one, a certain (one)
sund|water, sea, (ocean-)sound, strait
ge-sund|sound, safe, unharmed
sund-gebland|commotion of water, surging water
sund-nyt(t)|use of the water/ocean
sundor-nyt(t)|special service
sundur|asunder, separately
sund-wudu|sea-wood i.e. ship
sunne|sun
sunu,|son
súð|south(wards)
Súð-Dene|see Dene.
swá|so, thus, in this manner; as
swancor|supple, graceful
swan-rád|swan-road, sea
swát|(sweat), blood
swát-fáh|blood-stained
swátig|(sweaty), bloody
swát-swaðu|bloody track (swathe)
swaþrian|subside, become still
swaðu|track, (swathe)
swaþul|flame, heat
swaés|(one's) own, dear
swaés-líce|in a friendly manner, gently
swæþer|whichever of two
swebban|(put to sleep), kill
sweccan|smell
swefan|sleep, sleep in death
swefeð|see swebban.
swég,|sound, music, noise
swegl|sky, heaven
swegl|bright, brilliant
swegl-wered|clothed with radiance
swelan|burn(intr.)
swelgan|swallow
swellan|swell
sweltan|die
swencan|press hard, harass, afflict
sweng,|blow, stroke
sweofot|sleep
sweoloð|heat, flames
Swéon|Swedes
swéor-|see in compound áþum-swéoras.
sweorcan|become dark, become grievous
ge-sweorcan|be dark, lower
sweord|sword
sweord-bealo|sword-evil, death by the sword
sweord-freca|(sword-) warrior
sweotol|clear, manifest
Swéo-ðéod|the Swedish people
swerian|swear
Swerting|(maternal) uncle of Hygelác
swéte|sweet, fragrant, pure, pleasant
sweðrian|subside, diminish, cease
swícan|depart, escape
ge-swícan|fail, prove inefficient
swift|swift
swíge|silent
swígian|be silent
swilce|see swylce.
swín|(swine), image of a boar (on a helmet)
swincan|labour, toil
ge-swing|vibration, swirl, surf
swingan|fly
swín-líc|boar-figure
Swío-ríce|Sweden
swioðol|fire, flame
swíð|strong, harsh
swíðe|very, much, very much
swíð-ferhð|strong-minded, determined, brave
swíð-hicgende|strong-minded, valiant
swíð-mód|stout-hearted, strong-minded
swógan|resound, roar
swór|see swerian.
swulces|see swylc.
swurd|see sweord.
swurd-léoma|sword-light
swutol|see sweotol.
swylc|such
swylce|likewise, also; (such) as
swylt|death
swylt-dæg|day of death
swymman (swimman)|swim
swýn|see swín.
swynsian (swinsian)|make a (pleasing/cheerful) sound
swyrd|see sweord.
swyrd-gifu|giving of swords
swýð(e)|see swíð(e).
sý|see eom.
syfan-wintre|seven years (winters) old
syfone|see seofon.
syl(l) |sill, floor
sylf|see self.
syllan|see sellan.
syl-líc|see sel-líc.
symbel|feast, banquet
symbel-wyn(n)|joy of feasting, delightful feast
sym(b)le (sim(b)le)|ever, always, continuously
symle, ds.|see symbel.
syn(n)|sin, crime
syn-bysig|distressed by sin, guilty
syn-dolh (sin-)|very great wound
syndon|see eom.
ge-sýne|visible, evident
syn-gáles|see sin-gáles.
ge-syngian|sin, commit a crime
syn-scaþa|sin-scather, malefactor, miscreant, sinful criminal
syn-snaéd|huge morsel
synt|see eom.
ge-synto|health, safety
syrce|shirt of mail
syrwan|plot, ambush
syððan|see siððan.
tácen|token, sign, evidence
talian|suppose, consider (somebody or something to be such and such)
ge-taécan|show, point out, assign
ge-taése|agreeable
te|see tó.
téar|tear (from weeping)
tela|well, properly
telge|see tellan.
tellan|account, reckon, conside (somebody or something to be such and such)
ge-tenge|lying on, close to
teoh(h)|company, band, troop
teohhian|appoint, assign
ge-téon,|confer, bestow, grant
téon|draw
ge-téon|draw
ge-téon|assign, allot
tíd|time
til|good
tilian|strive after, earn, win, secure
timbran|build (timber)
tír|glory, honour
tír-éadig|glorious, famous
tír-fæst|glrious, famous
tír-léas|inglorious, vanquished
tíðian (tigðian)|grant
tó-, prefix|see the following words
tó-brecan|break (to pieces), shatter
tó-drífan|drive asunder, separate
tó-gædre|together
tó-géanes|opposite (towards somebody)
togen|see téon, II.
tó-glídan|(glide asunder), split (intr.)
tó-hlídan|crack, spring apart
tó-lúcan|pull asunder, destroy, dislocate
tó-middes|in the midst
torht|bright, resplendent
torn|anger
torn|grievous, bitter
torn-gemót|hostile meeting
tó-somne|together
tó-weccan|(wake up), stir up
tredan|tread, walk upon, traverse
treddian|step, go
trem(m)|step, space
tréow|truth, good faith, fidelity
tréowan|trust
tréow-loga|one flase to pledged faith (troth), traitor
trodu|track, footrprint
trum|strong
ge-trum|troop, company
truwian|trust, have faith in
ge-truwian|trust
tryddian|see treddian.
trýwe|true, faithful
ge-trýwe|true, faithful
twá|see twégen.
ge-twaéfan|separate, part, put an end to
ge-twaéman|separate, hinder
twégen|twá, f.(n.)|twain, two
twelf|twelve
twéone|two
týdre|weak, craven
týn|ten
þá|then; when
þá, pron.|see sé.
ðafian|consent to, submit to
þáh|see þéon, I.
ge-þah|see ge-þicgan.
þám|see sé.
þanan|see þonan.
þanc|thank(s)
þanc-hycgende|thoughtful
þancian|thank (for)
þanon|see þonan.
þára|see sé.
ge-þaégon|see ge-þicgan.
þaém, þaére, þæs|see sé.
þaér|there; where
þæt, pron.|see sé.
þæt|that
þætte|that
þé, pers. pron.|see þú.
þé, isn.|see sé.
þé, þe|who, which, that, etc.
þéah|nevertheless, however
ge-þeah|see ge-þicgan.
þearf|need, want, distress, difficulty, trouble
þearf|see þurfan.
þearfa|needy, lacking
ge-þearfian|necessitate, impose necessity
þearle|severly, hard
þéaw|custom, usage, manner
þec|see þú.
þeccean|cover, enfold
þegn|thane, follower, attendant, retainer, warrior, servant
þegn-sorg|sorrow for thanes
þégon, -un|see þicgan.
þéh|see þéah.
þehton|see þeccean.
þencan|think
ge-þencan|think, remember
þenden|while
þengel|prince
þénian|serve
þéod|people, nation, troop of warriors
þéod-cyning|king of a people
þéoden|lord, prince, king, chief
ðéoden-léas|lord-less, deprived of one's chief
þéod-gestréon|people's treasure, great treasure
ðéod-kyning|see þéod-cyning.
þéod-sceaða|people's foe/scather
Þéod-Scyldingas|see Scyldingas.
þéod-þréa|distress of the people, great calamity
þéof|thief
þéon|thrive, prosper
ge-þéon|prosper, flourish
þéon|see þýwan.
þéos|see þes, þés.
þéostre|dark, gloomy
þéow|slave, servant
þés, þéos, þis|this
þicgan|receive, take, partake of (food, drink)
ge-þicgan|receive, partake of, drink
þín|thy (thine)
þincean|see þyncan.
þing|thing, affair, matter
ge-þingan|determine, appoint, purpose
ge-þinge|agreement, compact
þingian|settle, compound
ðíod(-), þíoden|see þéod(-), þéoden.
þis|see þes, þés.
ge-þóht|thought
þolian|suffer, endure
ge-þolian|suffer, endure
þon|see sé.
þon|see þonne
þonan|thence
ge-þonc|thought
þone|see sé.
þonne|then; when
þonon|see þonan.
þorfte|see þurfan.
þrág|time
ge-þræc|press, heap
þréa-nédla|dire distress
þréa-nýd|distress, sad necessity
ðréat|crowd, company, troop
þréatian|press, harass, threaten
þrec-wudu|(might-wood), spear
þréo, num.|three
þreottéoða|thirteenth
þridda|third
ge-þring|throng, tumult
þringan|intr., throng, press forward
ge-þringan|intr., press (forward)
þrío|see þréo.
þríst-hýdig|bold-minded, brave
þrítig, num.|thirty
þrówian|suffer
ge-þuren|hammered
þrýd-líc|see þrýð-líc.
ðrym(m)|might, force
þrýð|(pl.), might, strength
ðrýþ-ærn|mighty house, splendid hall
þrýð-líc|mighty, powerful, splendid
Þrýðo|see Módþrýðo.
ðrýð-swýð (swíð)|strong/mighty (one?)
þrýð-word|strong (brave, noble) word(s)
þú|thou
þúhte|see þyncan.
ge-þungen|see þeon, I.
þunian|(thunder), creak, groan
þurfan|need, have good cause/reason
þurh|through
þurh-brecan|break through
þurh-dúfan|(dive) swim through
þurh-etan|eat through
ðurh-fón|penetrate
þurh-téon|bring about, effect
þurh-wadan|go through, penetrate
þus|thus, so
þúsend, num.|thousand
ge-þwaére|harmonious, united, loyal
þý|see sé.
þyder|thither
þýhtig|strong, firm
ge-þyld|patience
þyle|orator, spokesman, official entertainer
þyncan|seem, appear
þyrel, þýrel|pierced through
þyrs,|troll, ogre, giant
þys-líc|such, thusly
þýs, þysne, þysses, þyssum|see þes, þés.
þýstru|darkness
þýwan, þéon|oppress, threaten
ge-þýwe|customary, usual
ufan|from above
ufera|(higher), later
ufor|comp., higher up, farther away
úhta|time just before daybreak, dawn, twilight, dusk
úht-floga|twilight-, dusk-, night-flier
úht-hlem(m)|din or crash at dusk/dawn/night
úht-sceaða|depredator (scather) at dusk/twilight
umbor-wesende|being a child
un-, prefix|see following words
un-blíðe,|joyless, unhappy, sorrowful
un-byrnende|without burning
unc|see ic.
uncer|of us two
un-cúð|unknown
un-dearninga|without concealment, openly
under|under
undern-maél|morning-time
un-dyrne, -derne|not hidden, manifest
un-faécne|without deceit, sincere
un-faége|undoomed, not fated to die
un-faéger|unfair, horrible
Un-ferð|'þýle' of Hróðgár
un-flitme|undisputed
un-forht|unafraid, fearless, brave
un-forhte|fearlessly, without hesistation
un-fród|not old, young, unexperienced(?)
un-from|inactive, feeble
un-geára|not long, ago, recently
un-gedéfe-líce|unfittingly
un-gemete|without measure, exceedingly
un-gléaw|unwise, imprudent, foolish, unskilled, ignorant
un-gyfeðe (-gifeðe)|not granted, denied
un-haélo|evil, destruction
un-héore, -híore, -hýre|awful, frightful, monstrous
un-hlit-in|place in which fellowship is absent
un-hrór|weak, (made) useless
un-igmetes|without measure, exceedingly
un-léof|unloved, not loved
un-lifigende|unliving, not living, dead
un-lýtel|not little, great
un-murn-líce|(unmournfully), ruthlessly
unnan|not begrudge, wish (somebody to have something), grant
ge-unnan|grant
un-nyt(t)|useless
un-riht|wrong
un-rihte|(or ds. of unriht, n.), wrongfully
un-rím|countless number, infinity
un-ríme|countless, infinite
un-rót|sad, depressed
un-snyttru|folly (unwisdom)
un-sófte|(unsoftly), with difficulty, hardly
un-swíðe|not strongly
un-synnig|guiltless (unsinning)
un-synnum|(dp.), guiltlessly
un-taéle|blameless
un-týdre|evil brood, evil offspring
un-wác-líc|not (weak) mean
un-wearnum|(dp.), without hindrance, irresistibly
un-wrecen|unavenged
up|up(wards)
up-lang|upright
uppe|up, above
upp-riht|upright
úre|our
úrum, ús, úser|see ic.
úserne|see úre.
ússes, ússum|see úre.
út|out (motion)
útan|from without, outside
útan-weard|outside (outward)
út-fús|ready (eager) to set out
uton|let us
út-weard|turning outwards, striving to escape
úþe|see unnan.
úð-genge|departing (out-going)
wá|woe, ill
wacian|keep watch
wada, -o, -u|see wæd.
wadan|go, advance
ge-wadan|go, advance (to a certain point)
wág|wall
wala|re-inforced crest (on a helmet)
waldend|see wealdend.
wald-swaþu|forest-track, -path
wan|see won(n).
wandrian|wander, rove, circle
wang|see wong.
wanian|wane, diminish, waste away
waroð|shore
wást, wát|see witan.
waðol|wandering
wæccan|watch, be awake
wæcnan|waken, arise, spring, be born
wæd|water, sea
ge-waéde|dress, equipment, armour
waéfre|restless
waég-bora|wave-roamer
waége|cup, flagon
waég-holm|(billowy) sea
waég-líðend(e)|seafarer
Waég-mundingas|the family to which Wíhstán, Wígláf, and Béowulf belong
waég-sweord|sword with wavy ornamentation ( = damascened/pattern-welded sword)
wæl|those slain in battle (collect.), corpse(?)
wæl-bed(d)|bed of death
wæl-bend|deadly bond
wæl-bléat|deadly, mortal
wæl-déað|murderous death
wæl-dréor|blood/gore of slaughter
wæl-faéhð|deadly feud
wæl-fág|slaughter-stained
wæl-feal(l)|slaughter
wæl-fús|ready for death, eager for slaughter(?)
wæl-fyl(l),|slaughter
wæl-fyllo|abundance of (the) slain, fill of slaughter
wæl-fýr|murderous fire
wæl-gaést|murderous spirit
wæl-hlem(m)|slaughter-blow, onslaught
wæll-seax|slaughter-seax, battle-knife
wælm|see wylm.
wæl-níð|deadly hate, hostility
wæl-raés|murderous onslaught, bloody conflict
waél-ráp|water-rope/fetter (i.e. ice)
wæl-réaf|spoil of battle
wæl-réc|deadly (reek) fumes
wæl-réow|fierce in battle
wæl-rest|bed of slaughter
Wæls|father of Sigemund
wæl-sceaft|slaughter-(shaft, i.e.) spear
Wælsing|son of Wæls, (i.e. Sigemund)
wæl-sliht,|slaughter
wæl-steng|pole of/for the slain
wæl-stów|place of the slain/slaughter, battle-field
waén (wægn)|wain, waggon
waépen|weapon
waépned-mon(n)|(be)weaponed person/man, i.e., male creature, man
waér|agreement, treaty
wærc|pain, suffering
waére, waéran, -on, wæs|see eom.
wæstm|growth, stature, form
wæter|water, sea
wæter-egesa|water-terror, dreadful water(?)
wæter-ýð|wave of the sea
wé|see ic.
wéa|woe, misery, trouble
wéa-daéd|deed of woe
weal(l)|wall (artificial or natural
wéa-láf|woeful remnant, survivors of calamity
ge-wealc|rolling
ge-weald|power, control
wealdan|control, have power over, rule, wield, possess
ge-wealdan|control, wield
ge-wealden|see ge-wealdan.
wealdend|ruler, wielder, i.e., God
Wealh-þéo(w)|Hróðgár's queen
weallan|well, surge, boil
weall-clif|cliff (see weal(l))
weard|ward(en), watchman, guardian, keeper, lord, possessor
weard|ward, watch, vigil
weardian|ward, guard, occupy
wearn|(hindrance), refusal
wéa-spel(l)|tidings of woe
weaxan|wax, grow, increase, flourish
ge-weaxan|wax, increase
web(b)|web, tapestry
weccan|wake, rouse, stir up
wed(d)|pledge
weder|weather
Wederas|=Weder-Géatas
Weder-Géatas|see Géatas.
Weder-mearc|land of the (Weder-)Geats
weg|way
wég (waég)|wave
wegan|carry, wear, have (feelings)
ge-wegan|fight
wég-flota (waég-)|wake-floater, ship
wehte|see weccan.
wél, well|(always stressed), well, very much, rightly
Wéland|famous smith of Germanic legend
wél-hwylc|every (one)
welig|wealthy, rich
wél-þungen|accomplishd, excellent
wén|expectation
wénan|ween, expect, think
wendan|turn
ge-wendan|turn
Wendlas|Vandals
wennan|(accustom, attach to oneself), entertain, present
Wéoh-stán (Wéox-)|see Wíh-stán.
weora, gp.|see wer.
weorc|work, deed
ge-weorc|work
weorod|see werod.
weorpan|throw
weorð|valued, dear, honoured
weorð|worth, value, price
weorðan|happen, come to pass, arise
ge-weorðan|suit, seem good
weorð-ful(l) |worthy, illustrious
weorðian|honour, exalt
weorð-líce|worthily, splendidly
weorð-mynd|honour, glory
weotena|see wita.
weotian (witian)|in weotod, pp., appointed, ordained, assured, destined
wer|man
wered|sweet drink (mead?)
werga (wérga?)|accursed, evil
wérge, -um|see wérig.
(ge-)wérgian|weary, fatigue, tire
werhðo|torment, punishment, damnation
werian|defend, protect
wérig|weary
wérig-mód|weary-hearted, disheartened
werod|band, host, company, troop
wer-þéod|people, nation
wesan|see eom.
West-Dene|see Dene.
wéste|waste(d), deserted
wéste(n)|waste, desert, wilderness
wíc|dwelling place, abode
ge-wícan|give way, fail
wicg|horse
wíc-stede|dwelling-place, home, homestead
wíd|wide, extended, spacious, gsn.wk. wídan
wíd-cúþ|widely known, famous
wíde|widely, far and wide, far
wíde-ferhð|for a long time, forever, ever
wíd-floga|far-flier
ge-widre|weather, storm
wíd-scofen|pushed far, far-reaching, great
wíd-wegas|wide-stretched ways, distant/far-extending regions
wíf|woman, lady
ge-wif (or ge-wife) |web (of destiny), fortune
wíf-lufu (-lufe)|love for a woman (or wife)
wíg|war, fight, warfare
wiga|warrior
wígan|fight
wíg-bealu|war-bale, war
wíg-bil(l)|battle-sword, (-bill)
wíg-bord|battle-shield (board)
wíg-cræft|prowess, war-strength(/-craft/-skill)
wíg-cræftig|strong/skilful in battle
wígend|warrior
wigeð|see wegan.
wíg-freca|warrior
wíg-fruma|war-chief
wigge|see wíg.
wíg-getáwa|war-equipment
wíg-geweorþad|distinguished in battle (war-worthied)
wíg-gryre|war horror, martial terror/power
wíg-heafola|war-head, i.e. helmet
wíg-héap|band of warriors
wíg-hete|(war-hate), war
wíg-hryre|fall in fight
Wíg-láf|a Waégmunding, kinsman & retainer of Béowulf
wíg-sigor|(war-)victory
wíg-spéd|success in war, victory
wigtig|see wítig.
wíg-weorþung|honouring idols, religious sacrifice
Wíh-stán, Wéoh-stán|father of Wígláf
wiht|(wight), creature, being
wil-cuma|welcome person
wildéor [wild-déor]|wild beast
Wilfingas|see Wylfingas.
wil-geofa|joy-giver, lord
wil-gesíþ|dear companion
willa|will, wish, desire
willan|want to, wish, desire
wilnian|desire, ask for (gen.)
wil-síð|wished-for journey
wín|wine
wín-ærn|wine-hall
wind|wind
win-dæg|day or labour/strife
windan|wind, fly, curl, eddy
ge-windan|go, turn
wind-blond|tumult of winds
wind-geard|home of the winds
windig|windy
wine|friend, (friendly) lord/protector
wine-drihten|friend and lord
wine-geómor|mourning one's friends
wine-léas|friendless (ref. to exile)
wine-maég|friend and kinsman, retainer
winia, winigea|see wine.
ge-win(n)|strife, struggle, contest, fight
winnan|contend, fight, struggle
wín-rece|wine-hall
wín-sele|wine-hall
winter|winter
ge-wiofu|see ge-wif.
wír|wire, metal band, ornament
wís|wise
wísa|leader
wíscan (wýscan)|wish
wís-dóm|wisdom
wíse|wise, way, manner, fashion
wís-fæst|wise
wís-hycgende|wise in thought
wísian|show the way, guide, direct, lead
ge-wis-líce|certainly
wisse, -on|see witan.
wist|(sustenance), feast(ing), abundance, prosperity
wiste, -on|see witan.
wist-fyllo|fill of feasting, plentiful meal
wíston|see wíscan.
wit(t)|wit, intelligence
ge-wit(t)|intellect, senses, wit
wit, pers. pron.|see ic. [Go. wit]. see witan below for etyml. notes.
wita|wise man, councilor, advisor
witan|know
ge-witan|know, ascertain
wítan|lay to (somebody's) charge
ge-wítan|depart, go
wítig|wise
wítnian|punish, torment
witod|see weotian.
ge-wittig|wise, conscous
Wiðer-gyld|a Heaðo-Bard warrior
wiðer-ræhtes|opposite
wið-fón|lay hold of/on
wið-grípan|grapple with
wið-habban|hold out against, withstand
wiðre|resistance
wlanc|see wlonc.
wlátian|gaze, look out for
wlenco|pride, high spirit, daring
wlítan|look, gaze
wlite,|countenance, appearance, beauty
wlite-beorht|beautiful, fair, sublime
wlite-séon|sight, spectacle
wlitig|beautiful
wlonc|proud, high-spirited, bold, daring
wóc|see wæcnan.
wóh|crooked, perverse
wóh-bogen|bent, coiled
wolcen|cloud
wolde|see willan.
wollen-téar|with welling/gushing tears
wóm|see wóh.
wom(m)|stain, blot, evil
won, pret.|see winnan.
won(n)|dark, black
wong|plain, field, land, country, place
wong-stede|place
won-hýd (-hygd)|recklessness
Won-réd|a Geat, father of Eulf and Eofor
Won-réding|son of Wonréd (i.e. Wulf)
won-saélí (-sælig)|unhappy
won-sceaft|misery
wóp|weeping, lamentation
worc|see weorc.
word|word
word-cwide|words, speech
word-gyd(d)|lay, elegy
word-hord|word-hoard, store of words, (vocabulary)
word-riht|(word-right), right word, censure
worhte|see wyrcan.
worn|large number, great quantity
worold|world
worold-ár|worldly honour
worold-cyning|(earthly) king
worðig|enclosed homestead, precinct(s)
worð-mynd|see weorð-mynd.
woruld-candel|world-candle (sun)
woruld-ende|end of the world
worold-raédend|worldly practice, i.e., vengeance
wracu|revenge, vengeance, punishment
wraéc|(f.?|see B.-T.), misery, distress
wræcca|see wrecca.
wræce|see wracu.
wræc-lást (wraéc-?)|track/path of exile
wræc-mæcg (wraéc-?)|banished man, outcast
wræc-síð (wraéc-?)|exile, misery
wraét(t)|ornament, work of art
wraét-líc|ornamental, splendid, wondrous
wráð|hostile (subst.: foe), fierce
wráðe|grievously
wráð-líce|cruelly, severely
wrecan|drive, force
ge-wrecan|avenge, punish
wrecca|exile (wretch), adventurer, hero
wrecend|avenger
wreoþen-hilt|with twisted hilt
wrídian|grow, flourish
wrítan|cut, engrave (write)
(ge-)wríþan|(twist), bind
wrixl|exchange
wrixlan|change, vary, exchange
ge-wrixle|exchange
wróht|(accusation), quarrel, strife
wudu,|wood
wudu-réc|wood-smoke
wuldor|glory, splendour, honour
wuldor-torht|gloriously bright
wuldur-cyning|king of glory (=god)
wulf|wolf
Wulf|a Geat (warrior), son of Wonréd, brother of Eofor
Wulf-gár|an (Wendle) official at the court of Hróðgár
wulf-hliþ|wolf-slope, retreat of wolves
wund|wound
wund|wounded
wunden-feax|with (wound) plaited/braided hair, with curly mane
wunden-gold|wound gold
wunden-hals|with (wound) curved (neck i.e.) prow
wunden-maél|sword with (wound) curved/twisting markings, i.e. damascened/pattern-welded sword
wunden-stefna|ship with (wound) curved (stem) prow
wunder-fæt|wonderful vessel
wundor|wonder, wonderful thing
wundor-bebod|strange/mysterious command (advice)
wundor-déað|wondrous death
wundor-líc|wonderful, strange
wundor-síon|wondrous sight
wundor-smiþ|wonder-smith, smith who makes wondrous things or smith who works by wondrous art
wundur-máððum|wondrous jewel/treasure
wunian|dwell, live, remain, continue, be situated
ge-wunian|remain with, stand by (somebody)
wurð-|see weorð-.
wutun|see uton.
wyl(l)e, wyllað, wylt|see willan.
Wylfingas|a Germanic tribe
wylm|welling, surging, flood
wyn(n)|joy, delight, pleasure
wyn-léas|joyless
wyn-sum|joyous, pleasant, fair, winsome
wyrcan|work, do, make
ge-wyrcan|make, perform, carry out accomplish, achieve
wyrd|fate, destiny
wyrdan|injure, destroy
wyrm,|serpent
wyrm-cyn(n)|race of serpents
wyrm-fáh|serpent-patterned, (as applied to sword, i.e., pattern-welded, damascened)
wyrm-hord|dragon's (wyrm's) hoard
wyrp|change (for the better)
ge-wyrpan|refl., recover
wyrsa|worse
wyrt|root
wyrðe|worthy of, fit for
wyruld-|see worold-.
yfel|evil
ylca|(the) same
yldan|delay (trans.)
ylde|men
yldesta|see eald.
yldo|age, old age
yldra|see eald.
ylfe|elves
ymb-beorgan|protect (round about)
ymbe-fón|clasp, enclose
ymbe-hweorfan|move (intr.) about
ymb-éode|went round
ymb-sittan|sit round
ymb(e)-sittend|neighbouring peoples (those living [sitting] about, or on the borders)
yppe|raised floor, high seat
yrfe|heritage, lineage, genealogy
yrfe-láf|heirloom
yrfe-werad|(guardian of inheritance), heir
Yrmen-láf|a Dane
yrmþ(u)|misery
yrre|anger, ire
yrre|angry, irate
yrre-mód|angry (of mood)
yrringa|angrily
ys|see eom.
ýð|wave
ýðan|destroy
ýðe|see éaðe.
ýðe-líce|easily
ýð-geblond|tossing waves, surge, surging water, (blended water)
ýþ-geséne|see éþ-gesýne.
ýð-gewin(n)|wave-strife, struggle of the waves
ýþ-lád|way across the waves, sea-voyage
ýð-láf|leaving of waves, (sand on) shore
ýð-lida|wave-traverser, ship
ýwan|show, manifest
ge-ýwan|show, present, bestow
